S NO,Consistency No,Candidate,Party,EVM Votes,Postal Votes,Total Votes,% of Votes
1,191,PATEL ANTAR SINGH,Bahujan Samaj Party,3700,5,3705,1.97
2,191,CHOUHAN NAGAR SINGH,Bharatiya Janata Party,83311,453,83764,44.63
3,191,MUKESH PATEL,Indian National Congress,79022,1019,80041,42.65
4,191,Nawal Singh Mandloi,Independent,2691,15,2706,1.44
5,191,SURENDRA THAKRALA,Independent,11288,73,11361,6.05
6,191,HIRLA CHOUHAN,Independent,2268,7,2275,1.21
7,191,NOTA,None of the Above,3803,11,3814,2.03
8,223,DR. CHINTAMANI MALVIYA,Bharatiya Janata Party,106439,323,106762,57.44
9,223,MANOJ CHAWLA,Indian National Congress,33138,427,33565,18.06
10,223,GOVARDHAN PARMAR,Aazad Samaj Party (Kanshi Ram),3411,6,3417,1.84
11,223,PUSHPENDRA SURYWANSHI HATPIPLIYA,Peoples Party of India (Democratic),362,3,365,0.2
12,223,KISHOR MALVIYA,Independent,195,0,195,0.1
13,223,NAGULAL,Independent,348,2,350,0.19
14,223,PRAHALAD VERMA,Independent,467,0,467,0.25
15,223,PREMCHANDRA GUDDU,Independent,37763,115,37878,20.38
16,223,LAXMAN CHANDRAVANSHI,Independent,974,1,975,0.52
17,223,NOTA,None of the Above,1895,4,1899,1.02
18,66,CHHANGELAL KOL,Bahujan Samaj Party,21208,109,21317,11.51
19,66,Dr. RAJENDRA KUMAR SINGH,Indian National Congress,79907,1042,80949,43.72
20,66,RAMKHELAWAN PATEL,Bharatiya Janata Party,74017,442,74459,40.22
21,66,AKHILESH KUMAR PRAJAPATI,Peoples Party of India (Democratic),991,3,994,0.54
22,66,AJAY KUMAR KUSHWAHA,Jan Adhikar Party,207,1,208,0.11
23,66,Amit Tiwari (LALA Bhai),Bharatiya Jan Morcha Party,165,0,165,0.09
24,66,ASHISH KUSHWAHA,Bhartiya Shakti Chetna Party,200,0,200,0.11
25,66,BALKRISHNA YADAV,Samajwadi Party,289,0,289,0.16
26,66,Rameshvar Prasad Patel,Akhil Bhartiya Apna Dal,132,0,132,0.07
27,66,SHASHI SATYENDRA SHARMA,Vindhya Janta Party,301,4,305,0.16
28,66,GAURISHANKAR TRIVENI PRASAD TIWARI,Independent,290,0,290,0.16
29,66,BABA CHHOTE LAL NAT,Independent,207,0,207,0.11
30,66,Mo. Nasim,Independent,338,0,338,0.18
31,66,NEELAM-PUSHPENDRA PANDEY,Independent,1319,2,1321,0.71
32,66,Ramsufal Kewat,Independent,1065,0,1065,0.58
33,66,Er. Virendra Kumar Patel,Independent,998,0,998,0.54
34,66,SURAJ IS GOD,Independent,525,0,525,0.28
35,66,NOTA,None of the Above,1377,2,1379,0.74
36,123,KAMLESH PRATAP SHAH,Indian National Congress,108997,768,109765,48.35
37,123,MONIKA MANMOHAN SHAH BATTI,Bharatiya Janata Party,84407,272,84679,37.3
38,123,DEVIRAM BHALAVI,Gondvana Gantantra Party,18179,52,18231,8.03
39,123,ADVOCATE RAJKUMAR SARYAM,Janseva Gondwana Party,1177,4,1181,0.52
40,123,BHURELAL SARYAM,Independent,1377,0,1377,0.61
41,123,RAMPRASAD INVATI,Independent,721,1,722,0.32
42,123,VINOD DHURVE,Independent,903,2,905,0.4
43,123,Shivpratap Singh Thakur,Independent,1489,1,1490,0.66
44,123,SANTLAL PARTETI (ADVOCATE),Independent,3674,7,3681,1.62
45,123,NOTA,None of the Above,4997,6,5003,2.2
46,166,Dr.GANGARAM JOGCHAND,Bahujan Samaj Party,1688,6,1694,0.85
47,166,MADHAV SINGH (MADHU GEHLOT),Bharatiya Janata Party,101661,515,102176,51.46
48,166,VIPIN WANKHEDE,Indian National Congress,88433,741,89174,44.91
49,166,KAILASH MALVIYA,Samajwadi Party,1239,3,1242,0.63
50,166,AMIT PATHROD,Independent,275,1,276,0.14
51,166,Dr. JAGDISH PEERULAL MALVIYA,Independent,269,2,271,0.14
52,166,PREMNARAYAN MALVIYA,Independent,348,0,348,0.18
53,166,MOHAN BODANA,Independent,1122,1,1123,0.57
54,166,SURESH MALVIYA,Independent,777,1,778,0.39
55,166,NOTA,None of the Above,1487,4,1491,0.75
56,130,MANOJ MALVE,Indian National Congress,73891,717,74608,44.21
57,130,Dr. Yogesh Pandagre,Bharatiya Janata Party,86304,422,86726,51.4
58,130,RUPESH PANDOLE,Bahujan Mukti Party,1166,1,1167,0.69
59,130,Ranjana Wamne Vakil,Gondvana Gantantra Party,1603,6,1609,0.95
60,130,JOSUAA GANESH ATULKAR,Independent,314,1,315,0.19
61,130,SADARAM JHARBADE,Independent,537,2,539,0.32
62,130,HARIPLAL BIHARE,Independent,1008,2,1010,0.6
63,130,NOTA,None of the Above,2761,8,2769,1.64
64,32,JAJPAL SINGH ''JAJJI'',Bharatiya Janata Party,77484,323,77807,45.03
65,32,DHANPAL BERKHEDI,Bahujan Samaj Party,3037,18,3055,1.77
66,32,HARIBABOO RAI,Indian National Congress,85316,864,86180,49.87
67,32,GANESHRAM AHIRWAR,Aazad Samaj Party (Kanshi Ram),2357,3,2360,1.37
68,32,DEVENDRA BIJAURE,Socialist Unity Centre Of India (COMMUNIST),334,2,336,0.19
69,32,TULSIRAM AHIRWAR,Independent,112,0,112,0.06
70,32,NARENDRA SINGH,Independent,187,0,187,0.11
71,32,BUNDEL SINGH,Independent,192,0,192,0.11
72,32,SURENDRA SINGH,Independent,327,1,328,0.19
73,32,HANMANT SINGH PARIHAR,Independent,492,0,492,0.28
74,32,HARIOM JATAV,Independent,356,0,356,0.21
75,32,NOTA,None of the Above,1384,10,1394,0.81
76,87,BISAHU LAL SINGH,Bharatiya Janata Party,76692,418,77110,55.13
77,87,RAMESH KUMAR SINGH,Indian National Congress,55778,913,56691,40.53
78,87,SUDAMA KOL,Bahujan Samaj Party,2455,25,2480,1.77
79,87,GUNJAANSINGH,Independent,553,7,560,0.4
80,87,RAJENDRA PRASAD KOL,Independent,861,4,865,0.62
81,87,NOTA,None of the Above,2150,12,2162,1.55
82,202,"BHANWARSINGH SHEKHAWAT ""BABU JI""",Indian National Congress,92945,788,93733,49.79
83,202,RAJVARDHANSINGH PREM SINGH DATTIGAON,Bharatiya Janata Party,90162,595,90757,48.21
84,202,ISHWARSINGH CHAWDA,Independent,1030,9,1039,0.55
85,202,JITENDRA SINGH CHOUHAN,Independent,347,3,350,0.19
86,202,BHAMARSINGH URF BHANWARSINGH SHEKHAWAT,Independent,270,6,276,0.15
87,202,MANGILAL VASUNIYA,Independent,719,3,722,0.38
88,202,NOTA,None of the Above,1359,9,1368,0.73
89,218,JITENDRA UDAY SINGH PANDYA,Bharatiya Janata Party,80403,325,80728,46.96
90,218,NiRBHAy SiNGH CHANDRAVANSHi,Bahujan Samaj Party,3302,5,3307,1.92
91,218,MURLI MORWAL,Indian National Congress,43732,303,44035,25.62
92,218,KIshor Malviya,Independent,722,3,725,0.42
93,218,PRAKASH GOUD,Independent,10458,22,10480,6.1
94,218,RAJENDRA SINGH SOLANKI,Independent,30900,105,31005,18.04
95,218,NOTA,None of the Above,1620,4,1624,0.94
96,9,ARVIND BHADORIA,Bharatiya Janata Party,48819,495,49314,32.27
97,9,HARI SHANKAR FHOGI,Bahujan Samaj Party,18690,97,18787,12.29
98,9,HEMANT SATYADEV KATARE,Indian National Congress,68607,935,69542,45.51
99,9,OM PRAKASH JAREHA,Peoples Party of India (Democratic),502,5,507,0.33
100,9,POOJA-HEERENDRA PRATAP (PUR),Aazad Samaj Party (Kanshi Ram),289,3,292,0.19
101,9,MUNNA SINGH BHADOURIA,Samajwadi Party,10208,80,10288,6.73
102,9,ANIL SINGH,Independent,70,0,70,0.05
103,9,ABHISHEK MISHRA,Independent,30,0,30,0.02
104,9,ARVIND TYAGI,Independent,53,1,54,0.04
105,9,ARUN KATARE,Independent,28,3,31,0.02
106,9,ASHOK SINGH,Independent,96,1,97,0.06
107,9,ASHA RAM,Independent,236,1,237,0.16
108,9,UMESH GARG,Independent,89,1,90,0.06
109,9,KESHAV SINGH GURJAR,Independent,169,0,169,0.11
110,9,CHANDRAVEER SINGH KUSHWAH,Independent,108,1,109,0.07
111,9,CHANDRA PRAKASH SHARMA,Independent,563,0,563,0.37
112,9,DHARMENDRA TIWARI,Independent,215,0,215,0.14
113,9,DHARMENDRA SINGH MOURYA,Independent,124,0,124,0.08
114,9,NARENDRA SINGH BANSAL,Independent,262,0,262,0.17
115,9,NAVAL SINGH,Independent,60,0,60,0.04
116,9,PAN SINGH,Independent,79,0,79,0.05
117,9,PANKAJ SHARMA,Independent,59,0,59,0.04
118,9,BRAJENDER SINGH,Independent,26,0,26,0.02
119,9,MAHESH KUMAR,Independent,30,1,31,0.02
120,9,MAHESH SINGH YADAV,Independent,54,0,54,0.04
121,9,MEERA DEVI,Independent,58,0,58,0.04
122,9,RAVI BAGHEL,Independent,230,1,231,0.15
123,9,RAJ KISHOR SHARMA,Independent,79,0,79,0.05
124,9,RAJEEV,Independent,43,0,43,0.03
125,9,RADHAMOHAN,Independent,83,0,83,0.05
126,9,RAMDAS GURJAR,Independent,71,1,72,0.05
127,9,RAMVILASH,Independent,214,0,214,0.14
128,9,RAHUL SHARMA,Independent,167,0,167,0.11
129,9,VIJAY SINGH KUSHVAH,Independent,40,1,41,0.03
130,9,VINOD KUMAR JATAV,Independent,129,0,129,0.08
131,9,SATYA PRAKASH PATHAK,Independent,35,0,35,0.02
132,9,SATENDRA SINGH BHADORIYA (CHACHA),Independent,370,1,371,0.24
133,9,SUNEEL KUMAR,Independent,34,0,34,0.02
134,9,NOTA,None of the Above,164,4,168,0.11
135,157,KAMAL SINGH CHAUHAN,Indian National Congress,109625,1222,110847,47.08
136,157,GOPAL SINGH ENGINEER,Bharatiya Janata Party,117778,972,118750,50.44
137,157,BADRILAL KATARIA,Bahujan Samaj Party,1847,7,1854,0.79
138,157,AJAY PARMAR,Aazad Samaj Party (Kanshi Ram),887,0,887,0.38
139,157,AMBARAM MALVIYA,Samajwadi Party,261,3,264,0.11
140,157,KAMALSINGH JANGDHA,Rashtriya Jan Awaz Party,454,5,459,0.19
141,157,SOBHAL SISODIYA,Samata Samadhan Party,145,0,145,0.06
142,157,NARESH CHANDRA SURYAVANSHI,Independent,277,1,278,0.12
143,157,SANTOSH KUMAR DAMDIYA,Independent,472,2,474,0.2
144,157,NOTA,None of the Above,1458,9,1467,0.62
145,180,ARCHANA DIDI,Bharatiya Janata Party,99680,717,100397,40.67
146,180,BHAIYYA SAHEB SUNIL NAYKE,Bahujan Samaj Party,1362,16,1378,0.56
147,180,"THAKUR SURENDRA SINGH ""SHERA BHAIYA""",Indian National Congress,68586,640,69226,28.04
148,180,UMAR MAKNIC,Jai Prakash Janata Dal,518,3,521,0.21
149,180,DATTU VASANT MEDHE,Aazad Samaj Party (Kanshi Ram),833,8,841,0.34
150,180,DHRUVRAJ DEVANAND TAYADE,Vanchit Bahujan Aaghadi,321,3,324,0.13
151,180,NAFEES MANSHA,All India Majlis-E-Ittehadul Muslimeen,33792,61,33853,13.71
152,180,DADA SAHEB WAMANRAO SASANE,Bahujan Mukti Party,475,8,483,0.2
153,180,KAILASH WAGHE,Independent,248,4,252,0.1
154,180,BHIKA PASI,Independent,245,5,250,0.1
155,180,HINDU NETA BHUSHAN NANDKISHOR PATHAK,Independent,547,0,547,0.22
156,180,"MOHAMMAD HANIF SHAIKH RAUF (ADVOCATE) ""HANNU DADA""",Independent,751,1,752,0.3
157,180,"HARSHVARDHAN NANDKUMAR SINGH CHOUHAN ""HARSHU BHAIYA''",Independent,35093,342,35435,14.36
158,180,NOTA,None of the Above,2561,22,2583,1.05
159,156,VIKRAM MASTAL SHARMA,Indian National Congress,59466,511,59977,25.71
160,156,SHIVRAJ SINGH CHOUHAN,Bharatiya Janata Party,163823,1128,164951,70.7
161,156,DINESH AZAD,Aazad Samaj Party (Kanshi Ram),2360,3,2363,1.01
162,156,DHARMENDRA SINGH PANWAR (GOLU JANPAD),Right to Recall Party,378,5,383,0.16
163,156,OBC PRAHALAD-CHAURASIA,Gondvana Gantantra Party,424,5,429,0.18
164,156,MAHAMANDLESWAR SWAMI VAIRAGYANAND,Samajwadi Party,136,0,136,0.06
165,156,ABDUL RASHED,Independent,103,0,103,0.04
166,156,CHOTELAL,Independent,114,3,117,0.05
167,156,PRAMNARAYAN,Independent,233,4,237,0.1
168,156,BRIJMOHAN DHURVE,Independent,1440,11,1451,0.62
169,156,VIJAY NANDAN,Independent,487,1,488,0.21
170,156,HEMRAJ PETHARI,Independent,974,5,979,0.42
171,156,NOTA,None of the Above,1693,7,1700,0.73
172,35,ADV. NIRMLA SAPRE,Indian National Congress,72056,402,72458,50.43
173,35,MAHESH RAI,Bharatiya Janata Party,66016,287,66303,46.15
174,35,RAMENDRA AHIRWAR,Bahujan Samaj Party,2065,7,2072,1.44
175,35,AHIRWAR DEEPAK KUMAR,Samajwadi Party,401,1,402,0.28
176,35,JEEVAN,Independent,131,2,133,0.09
177,35,DASHRATH,Independent,130,0,130,0.09
178,35,NEELESH SINGH PAWAR,Independent,335,2,337,0.23
179,35,RAMSINGH CHADAR,Independent,603,2,605,0.42
180,35,NOTA,None of the Above,1233,6,1239,0.86
181,52,AMIT BHATNAGAR,Aam Aadmi Party,4179,6,4185,2.49
182,52,Advocate- CHARAN SINGH YADAV,Indian National Congress,55506,255,55761,33.24
183,52,MAHENDRA KUMAR GUPTA,Bahujan Samaj Party,10418,25,10443,6.23
184,52,BABLU RAJESH SHUKLA,Bharatiya Janata Party,87950,273,88223,52.59
185,52,CHETRAM AHIRWAR,Aazad Samaj Party (Kanshi Ram),1880,5,1885,1.12
186,52,PARAM LAL PATEL,Bhartiya Shakti Chetna Party,456,1,457,0.27
187,52,RISHI RAJ YADAV,Samajwadi Aam Janata Dal,626,1,627,0.37
188,52,LEELADHAR RAJPOOT,Bharatiya Sabhyata Party,345,0,345,0.21
189,52,CHARAN SINGH YADAV,Independent,294,0,294,0.18
190,52,JAGDISH SHIMAL KUSHWAHA,Independent,961,2,963,0.57
191,52,JAGDISH PRASAD MISHRA,Independent,480,0,480,0.29
192,52,BHAGIRATH TIWARI JASGUWAN,Independent,839,2,841,0.5
193,52,Mohammad. FAREED,Independent,988,0,988,0.59
194,52,AHIRWAR RAMDEVI,Independent,817,1,818,0.49
195,52,NOTA,None of the Above,1431,2,1433,0.85
196,105,NARAYAN SINGH PATTA,Indian National Congress,88174,1048,89222,41.68
197,105,Dr. VIJAY ANAND MARAVI,Bharatiya Janata Party,77905,252,78157,36.51
198,105,Engg. KAMLESH TEKAM,Gondvana Gantantra Party,38998,117,39115,18.27
199,105,VINEET TOPPO,Independent,1589,3,1592,0.74
200,105,SUNIL UIKEY,Independent,1566,3,1569,0.73
201,105,NOTA,None of the Above,4416,4,4420,2.06
202,161,NARAYAN SiNGH PANWAR,Bharatiya Janata Party,117055,791,117846,57.61
203,161,PURUSHOTTAM DANGI,Indian National Congress,80599,1036,81635,39.91
204,161,RiTiK YADAV,Bahujan Samaj Party,1756,14,1770,0.87
205,161,UDAY SINGH JATAV,Aazad Samaj Party (Kanshi Ram),574,4,578,0.28
206,161,KAMLESH GUPTA,Parivartan Party of India,158,1,159,0.08
207,161,ANKIT KUMAR,Independent,291,0,291,0.14
208,161,NARAYAN SiNGH S/O AMARCHAND,Independent,214,3,217,0.11
209,161,NARAYAN SiNGH S/O SHIVJIRAM,Independent,238,0,238,0.12
210,161,MUKESH JATAV,Independent,157,1,158,0.08
211,161,EN' RAVI KUMAR BADONIYA,Independent,239,2,241,0.12
212,161,HEMRAJ PRAJAPATi,Independent,378,2,380,0.19
213,161,NOTA,None of the Above,1046,5,1051,0.51
214,150,ATIF ARIF AQUEEL,Indian National Congress,95736,389,96125,56.38
215,150,ALOK SHARMA,Bharatiya Janata Party,68650,488,69138,40.55
216,150,MAHENDRA WANKHEDE,Bahujan Samaj Party,499,12,511,0.3
217,150,MOHAMMAD SAOOD,Aam Aadmi Party,723,12,735,0.43
218,150,PRAKASH NARVARE,Azad Samaj Party,197,0,197,0.12
219,150,PREM NARAYAN SWARNKAR (SONI JI),National World Leader Party,97,2,99,0.06
220,150,RAMDEEN BHAT,Bhartiya Shakti Chetna Party,29,2,31,0.02
221,150,Ataullah,Independent,67,0,67,0.04
222,150,ASHRAF ALI,Independent,80,1,81,0.05
223,150,AAMIR AQUEEL,Independent,1820,17,1837,1.08
224,150,NASIR ISLAM,Independent,545,5,550,0.32
225,150,MOHSIN ALI KHAN,Independent,64,0,64,0.04
226,150,WASEEM KHAN,Independent,67,0,67,0.04
227,150,RAJA BHAI (SHAHWAR),Independent,80,0,80,0.05
228,150,SURAYA,Independent,135,0,135,0.08
229,150,NOTA,None of the Above,766,8,774,0.45
230,153,ARIF MASOOD,Indian National Congress,81672,699,82371,54.33
231,153,UDHAM SINGH,Bahujan Samaj Party,533,27,560,0.37
232,153,DHRUV NARAYAN SINGH,Bharatiya Janata Party,65439,1041,66480,43.84
233,153,Mrs. DEEPA SAHU,Bhartiya Shakti Chetna Party,316,6,322,0.21
234,153,DURGA PRASAD,Parivartan Party of India,63,4,67,0.04
235,153,NEERAV HETAWAL,Bhartiya Gan Varta Party,38,0,38,0.03
236,153,SHAMA TANWEER,Aazad Samaj Party (Kanshi Ram),115,1,116,0.08
237,153,SYED AZHAR HUSAIN,Independent,30,0,30,0.02
238,153,ASHIF ALI,Independent,51,0,51,0.03
239,153,KESHAVRAO KOSE,Independent,43,0,43,0.03
240,153,ZEESHAN REHMAN,Independent,42,1,43,0.03
241,153,Advocate - Devendra Prakash Mishra,Independent,92,3,95,0.06
242,153,FAIZAL 3,Independent,99,1,100,0.07
243,153,Ram,Independent,98,1,99,0.07
244,153,RIZWAN UDDIN,Independent,60,0,60,0.04
245,153,NOTA,None of the Above,1126,25,1151,0.76
246,152,P.C. SHARMA (PRAKASH MANGEELAL SHARMA),Indian National Congress,58855,2001,60856,43.06
247,152,BHAGWANDAS SABNANI,Bharatiya Janata Party,75179,1510,76689,54.27
248,152,ADVOCATE SUDHIR UBNARE,Bahujan Samaj Party,1508,49,1557,1.1
249,152,KESHAV,National Jagaran Party,73,0,73,0.05
250,152,DINESH KUMAR JAIN,Rashtriya Jan Awaz Party,116,1,117,0.08
251,152,SURENDRA SHUKLA,Bhartiya Gan Varta Party,93,2,95,0.07
252,152,IRFAN ULLAH KHAN,Independent,248,4,252,0.18
253,152,PRAKASH SONVANE,Independent,45,3,48,0.03
254,152,PRADEEP KHANDELWAL,Independent,89,1,90,0.06
255,152,PRADEEP SAXENA,Independent,140,0,140,0.1
256,152,VIKAS SHARMA,Independent,204,4,208,0.15
257,152,NOTA,None of the Above,1161,28,1189,0.84
258,141,RAJKUMAR PATEL,Indian National Congress,77727,783,78510,38.3
259,141,SURENDRA PATWA,Bharatiya Janata Party,118737,552,119289,58.2
260,141,KAMLESH UIKE,Gana Suraksha Party,1988,6,1994,0.97
261,141,GUNDESH KUMAR KHAMBRA,Jai Lok Party,181,2,183,0.09
262,141,NAYANTARA DR. DHARMENDRA AHIRWAR,Aazad Samaj Party (Kanshi Ram),698,2,700,0.34
263,141,MONU,Akhand Bharat Samrajya Party,232,1,233,0.11
264,141,CAPTAIN ANIL KUMAR KHARE,Independent,149,0,149,0.07
265,141,CHANDAN SINGH,Independent,202,4,206,0.1
266,141,PHOOL KUMAR PRAJAPATI,Independent,275,0,275,0.13
267,141,MANOJ KUMAR CHAUBEY,Independent,195,0,195,0.1
268,141,MANOJ CHOUHAN,Independent,438,1,439,0.21
269,141,SEEMA PORTE,Independent,1066,2,1068,0.52
270,141,NOTA,None of the Above,1721,3,1724,0.84
271,18,KALICHARAN (PAPPu GuRJAR),Bahujan Samaj Party,3780,12,3792,2.07
272,18,MOHAN SINGH RATHORE,Bharatiya Janata Party,96626,374,97000,53.05
273,18,LAKHAN SINGH YADAV,Indian National Congress,74182,464,74646,40.82
274,18,BADAM SINGH BAGHEL,Samatamoolak Samaj Party,796,3,799,0.44
275,18,PROFESSOR VIJAY KUSHWAH,Jan Adhikar Party,922,3,925,0.51
276,18,SATENDRA SiNGH RAWAT,Aazad Samaj Party (Kanshi Ram),944,5,949,0.52
277,18,SANT RAJESWAR GIRI,Samajwadi Party,321,1,322,0.18
278,18,AGAR SINGH,Independent,180,0,180,0.1
279,18,CHAND KHAN,Independent,742,0,742,0.41
280,18,DHARMENDRA CHAUDHARI,Independent,676,3,679,0.37
281,18,MANMOHAN SHARMA,Independent,296,5,301,0.16
282,18,PANDIT RAM MUDGAL,Independent,311,0,311,0.17
283,18,Sushil Kumar Kushwah,Independent,530,2,532,0.29
284,18,SANJAY KUSHWAH,Independent,642,0,642,0.35
285,18,NOTA,None of the Above,1029,3,1032,0.56
286,10,NARENDRA SINGH KUSHWAH,Bharatiya Janata Party,65588,832,66420,40.96
287,10,CHAUDHARY RAKESH SINGH CHATURVEDI,Indian National Congress,50570,1704,52274,32.24
288,10,RAHUL SINGH KUSHWAH,Aam Aadmi Party,3032,24,3056,1.88
289,10,SANJEEV SINGH (SANJU),Bahujan Samaj Party,34583,355,34938,21.55
290,10,BABOORAM JAMOR,Aazad Samaj Party (Kanshi Ram),689,8,697,0.43
291,10,RAVISEN JAIN NETAJI,Samajwadi Party,226,11,237,0.15
292,10,REKHA MUNNA SHAKYA,All India Forward Bloc,128,5,133,0.08
293,10,SUBHASH CHAND KORKOO,Jai Prakash Janata Dal,93,0,93,0.06
294,10,HOSHIYAR SINGH (SHIVAM CHOUDHARY),Samatamoolak Samaj Party,114,0,114,0.07
295,10,ANIL SHARMA,Independent,220,0,220,0.14
296,10,APARN,Independent,81,2,83,0.05
297,10,KARAN SINGH RAJAWAT,Independent,135,0,135,0.08
298,10,KHEMSINGH,Independent,328,0,328,0.2
299,10,GUDIYA,Independent,178,0,178,0.11
300,10,DEEPSINGH,Independent,571,1,572,0.35
301,10,NARENDRA SINGH,Independent,741,0,741,0.46
302,10,PRADEEP SINGH BHADORIYA,Independent,512,0,512,0.32
303,10,MANOJ JAIN,Independent,216,0,216,0.13
304,10,MAMTA MISHRA,Independent,72,1,73,0.05
305,10,ADVOCATE MAHAVIR SINGH KUSHWAH,Independent,272,0,272,0.17
306,10,KU. RATNA KUSHWAH,Independent,103,1,104,0.06
307,10,ADVOCATE-RAJESH RAIPURIYA,Independent,78,0,78,0.05
308,10,DR. RAM KUMAR TRIPATHI (SITI),Independent,79,0,79,0.05
309,10,VIRENDRA VERMA,Independent,172,2,174,0.11
310,10,NOTA,None of the Above,413,9,422,0.26
311,181,JAVANSINGH SUKLAL MORE,Bahujan Samaj Party,2044,4,2048,1.06
312,181,SMT JHUMA DR DHYANSINGH SOLANKI,Indian National Congress,91838,297,92135,47.47
313,181,NANDA BRAHMNE,Bharatiya Janata Party,91398,134,91532,47.16
314,181,ASHVIN DHUPE,Bharat Adivasi Party,2520,6,2526,1.3
315,181,MOHANSINGH PATEL,Independent,2725,10,2735,1.41
316,181,SURESH MUJALDE (JAYAS),Independent,1296,5,1301,0.67
317,181,NOTA,None of the Above,1798,1,1799,0.93
318,21,GHANSHYAM PIRONIYA,Bharatiya Janata Party,52227,378,52605,37.62
319,21,PHOOL SINGH BARAIYA,Indian National Congress,81168,875,82043,58.67
320,21,CHAuDHARI RAJu DoHARE,Bahujan Samaj Party,1940,14,1954,1.4
321,21,RAMANI JATAV,Aam Aadmi Party,239,5,244,0.17
322,21,D.R. RAHUL,Samajwadi Party,366,4,370,0.26
323,21,ATAR SINGH,Independent,126,6,132,0.09
324,21,UDAL SINGH THAKUR (KHANGAR),Independent,183,5,188,0.13
325,21,RAKESH,Independent,270,2,272,0.19
326,21,SUSHIL-RADHEY SHYAM CHANDORIYA,Independent,845,0,845,0.6
327,21,NOTA,None of the Above,1168,7,1175,0.84
328,133,DHARMU SINGH SIRSAM,Indian National Congress,88982,726,89708,40.15
329,133,MAHENDRA SINGH KESHAR SINGH CHOUHAN,Bharatiya Janata Party,97584,354,97938,43.84
330,133,ANNULAL DADA,Gondvana Gantantra Party,2240,8,2248,1.01
331,133,RAHUL SATISH CHAUHAN,Prahar Janshakti Party,9576,27,9603,4.3
332,133,CHAITRAM KASDEKAR,Independent,2108,18,2126,0.95
333,133,RAMA- RATAN KAKODIA,Independent,936,6,942,0.42
334,133,SANDEEP DHURVE,Independent,10430,48,10478,4.69
335,133,HEMRAJ BARASKAR,Independent,5174,62,5236,2.34
336,133,NOTA,None of the Above,5125,6,5131,2.3
337,186,KEDAR CHIDABHAI DAWAR,Indian National Congress,98272,771,99043,49.8
338,186,CHANDAR SINGH WASKLE,Bharatiya Janata Party,86625,251,86876,43.68
339,186,RAKESH RAJARAM MANDLOI,Bahujan Samaj Party,1692,2,1694,0.85
340,186,CHHATAR SINGH MANDLOI,Independent,1174,5,1179,0.59
341,186,MOHAN VISHRAM KIRADE,Independent,5967,28,5995,3.01
342,186,VIJAY DALSINGH SOLANKI,Independent,1296,2,1298,0.65
343,186,NOTA,None of the Above,2804,2,2806,1.41
344,131,NILAY VINOD DAGA,Indian National Congress,92106,1544,93650,44.47
345,131,HEMANT VIJAY KHANDELWAL,Bharatiya Janata Party,108229,954,109183,51.85
346,131,SHIVPAL SINGH RAJPUT,Gondvana Gantantra Party,889,6,895,0.43
347,131,ALSYA SOLANKI MAMA,Independent,368,4,372,0.18
348,131,JOSUAA GANESH,Independent,151,0,151,0.07
349,131,NARAYAN PAWAR,Independent,121,1,122,0.06
350,131,PAWAN KUMAR,Independent,68,2,70,0.03
351,131,PRAVEEN VAMNKER,Independent,164,4,168,0.08
352,131,MAHESH SHAH UIKEY,Independent,568,4,572,0.27
353,131,RAJU CHARPE,Independent,143,1,144,0.07
354,131,ROSHAN KUMAR ATULKAR,Independent,226,2,228,0.11
355,131,VIJENDRA GOLE,Independent,802,0,802,0.38
356,131,HEMANT SARIYAM,Independent,1161,5,1166,0.55
357,131,NOTA,None of the Above,3028,21,3049,1.45
358,149,JAYSHREE HARIKARAN,Indian National Congress,81772,675,82447,41.78
359,149,VISHNU KHATRI,Bharatiya Janata Party,107267,577,107844,54.65
360,149,MASTAR VISHRAM SINGH AHIRWAR (BOUDDH),Bahujan Samaj Party,2564,31,2595,1.31
361,149,JAY SINGH,National World Leader Party,570,1,571,0.29
362,149,NEELESH MEHAR,Bhartiya Veer Dal,450,2,452,0.23
363,149,PRAKASH,Parivartan Party of India,214,1,215,0.11
364,149,AHIRWAR VINOD,Aazad Samaj Party (Kanshi Ram),495,4,499,0.25
365,149,SANTOSH AHIRWAR,Rashtriya mahan Gantantra Party,296,1,297,0.15
366,149,SHIV NARAYAN AHIRWAR URF (SHIBBU BHAIYA),Independent,601,3,604,0.31
367,149,NOTA,None of the Above,1819,10,1829,0.93
368,83,RAMLAKHAN SINGH,Indian National Congress,75274,1060,76334,36.44
369,83,SHARAD JUGLAL KOL,Bharatiya Janata Party,102542,274,102816,49.09
370,83,DEVIDEEN BAIGA,Sapaks Party,3229,2,3231,1.54
371,83,PURUSHOTTAM SINGH MARAVI,Gondvana Gantantra Party,21256,23,21279,10.16
372,83,RAMDARASH MAJHI,Peoples Party of India (Democratic),1991,2,1993,0.95
373,83,NOTA,None of the Above,3796,4,3800,1.81
374,145,NISHANK JAIN,Indian National Congress,70159,896,71055,40.55
375,145,RUKSAD BEE,Bahujan Samaj Party,958,15,973,0.56
376,145,"HARISINGH RAGHUWANSHI ""BADDA""",Bharatiya Janata Party,98064,658,98722,56.33
377,145,ASHOK LALARAM KUSHWAH,Vastavik Bharat Party,1784,3,1787,1.02
378,145,MOKAM SINGH KUSHWAH,Jan Adhikar Party,337,2,339,0.19
379,145,CHUNNILAL VIJAY KUSHWAH,Independent,494,0,494,0.28
380,145,NIRVESH MEENA,Independent,783,1,784,0.45
381,145,NOTA,None of the Above,1078,14,1092,0.62
382,91,DHIRENDRA BAHADUR SINGH DHIRU,Bharatiya Janata Party,112644,272,112916,56.92
383,91,VIJAY RAGHVENDRA SINGH (BASANT SINGH),Indian National Congress,61416,507,61923,31.21
384,91,ARVIND SINGH TEKAM,Gondvana Gantantra Party,10032,28,10060,5.07
385,91,SUSHRI KUNTI KOL,Samajwadi Party,513,6,519,0.26
386,91,JABAHAR SINGH,Aapka Gantantra Party,465,1,466,0.23
387,91,SURESH KOL,Communist Party of India,3307,9,3316,1.67
388,91,GEETA SINGH,Independent,4248,25,4273,2.15
389,91,DURGA MOSI,Independent,1520,1,1521,0.77
390,91,NOTA,None of the Above,3379,7,3386,1.71
391,96,AANAND SINGH LODHI,Aam Aadmi Party,2350,5,2355,1.19
392,96,NEERAJ SINGH LODHI,Bharatiya Janata Party,109080,426,109506,55.36
393,96,"SANJAY YADAV ""SEONI TOLA""",Indian National Congress,68913,636,69549,35.16
394,96,ANEETA PATEL,Bhartiya Shakti Chetna Party,1648,3,1651,0.83
395,96,ASHISH MISHRA,Samajwadi Party,385,0,385,0.19
396,96,JAYKANT SOBARAN SINGH (BABUJI),Vastavik Bharat Party,1433,9,1442,0.73
397,96,MANGILAL MARAVI,Gondvana Gantantra Party,8364,29,8393,4.24
398,96,MUNNA LODHI,Independent,1261,3,1264,0.64
399,96,MONU SATYA SINGH PATEL,Independent,1421,1,1422,0.72
400,96,NOTA,None of the Above,1826,10,1836,0.93
401,114,ARJUN SINGH KAKODIA,Indian National Congress,94029,964,94993,43.93
402,114,KAMAL MARSKOLE,Bharatiya Janata Party,111614,460,112074,51.83
403,114,KIRAN MARKAM,Bahujan Samaj Party,1678,16,1694,0.78
404,114,ANIL SINGH GOND(GONGE BHAIYA),Sanyukt Kranti Party,350,2,352,0.16
405,114,RAJKUMAR SARYAM ( RAJJU),Rashtriya Gondvana Party,369,5,374,0.17
406,114,RAJKUMARI DHURVE,Mahakaushal Rashtriya Party,290,0,290,0.13
407,114,SAWAN KUMAR,Bahujan Mukti Party,391,2,393,0.18
408,114,AJAY PARTE,Independent,470,3,473,0.22
409,114,YASHPAL BHALAVI (MASAB),Independent,567,1,568,0.26
410,114,SUNIL UIKEY,Independent,2793,3,2796,1.29
411,114,NOTA,None of the Above,2195,14,2209,1.02
412,89,SHIVNARAYAN GYAN SINGH (LALLU BHAIYA),Bharatiya Janata Party,89568,386,89954,49.51
413,89,SAVITRI SINGH DHURVE,Indian National Congress,65476,767,66243,36.46
414,89,JAGDISH SINGH,Vindhya Janta Party,1505,6,1511,0.83
415,89,BALA SINGH TEKAM,Gondvana Gantantra Party,16853,87,16940,9.32
416,89,MADHURI SINGH,Bhartiya Shakti Chetna Party,870,2,872,0.48
417,89,RAJBHAN SINGH,Peoples Party of India (Democratic),490,6,496,0.27
418,89,SAVITRI URF MAMMI KOL,Sapaks Party,641,6,647,0.36
419,89,KANTI DEVI MARAVI,Independent,722,0,722,0.4
420,89,CHAMARU SINGH,Independent,1069,3,1072,0.59
421,89,NOTA,None of the Above,3236,7,3243,1.78
422,42,"TARVAR SINGH LODHI ""BANTU BHAIYA""",Indian National Congress,55600,560,56160,28.93
423,42,KUNWAR RANJOR SINGH BUNDELA,Bahujan Samaj Party,13698,67,13765,7.09
424,42,VEERENDRA SINGH LODHI,Bharatiya Janata Party,90634,277,90911,46.83
425,42,SUDHIR YADAV,Aam Aadmi Party,24422,70,24492,12.62
426,42,BHANUPRATAP SINGH LODHI,Bhartiya Shakti Chetna Party,1501,1,1502,0.77
427,42,RAM BHAJAN BANSHAL,Bharatiya Sampuran Krantikari Party,246,1,247,0.13
428,42,SUNEEL JAIN (MAGARDHA),Samajwadi Party,382,2,384,0.2
429,42,CHAND KHAN,Independent,569,0,569,0.29
430,42,Ad. PUSHPENDRA AHIRWAR,Independent,336,4,340,0.18
431,42,BHAGWANDAS YADAV,Independent,295,0,295,0.15
432,42,ROVA,Independent,438,2,440,0.23
433,42,LAXMAN SINGH,Independent,681,0,681,0.35
434,42,"VEERENDRA SINGH LODHI ""LAMBARDAR""",Independent,2250,0,2250,1.16
435,42,VIRENDRA BHAIYA,Independent,684,1,685,0.35
436,42,NOTA,None of the Above,1407,2,1409,0.73
437,28,RISHI AGRAWAL,Indian National Congress,92965,743,93708,51.19
438,28,Manisha Rajesh Singh Dhakad,Bahujan Samaj Party,3483,13,3496,1.91
439,28,MAHENDRA SINGH SISODIA (SANJU BHAIYA),Bharatiya Janata Party,78543,369,78912,43.11
440,28,URmila Bai,Lok Samaj Party,1296,1,1297,0.71
441,28,Dɤ. PHooL SiNGH KUSHWAH,Pichhara Samaj Party United,306,0,306,0.17
442,28,RANJANA KUSHWAH,Aazad Samaj Party (Kanshi Ram),819,3,822,0.45
443,28,SHRiRAM SEN,Socialist Unity Centre Of India (COMMUNIST),245,0,245,0.13
444,28,AMIT SHRIVASTAVA GUNA WALE,Independent,196,1,197,0.11
445,28,ASHISH (LAL MAHARAJ),Independent,262,2,264,0.14
446,28,KRiSHN RAO. KAPSE (KAPSE BABU),Independent,361,1,362,0.2
447,28,SANTOSH,Independent,702,0,702,0.38
448,28,SURAJ LAL LODHA HARIPUR,Independent,669,0,669,0.37
449,28,NOTA,None of the Above,2058,6,2064,1.13
450,111,ANUBHA MUNJARE,Indian National Congress,106796,1974,108770,54.83
451,111,KAMAL KISHOR RAUT,Bahujan Samaj Party,1646,56,1702,0.86
452,111,GAURISHANKAR BISEN CHATURBHUG BISEN,Bharatiya Janata Party,78735,840,79575,40.11
453,111,SHIV JAISWAL,Aam Aadmi Party,1015,6,1021,0.51
454,111,JITENDRA GOYAL,Bahujan Mukti Party,138,2,140,0.07
455,111,DINESH,Peoples Party of India (Democratic),131,1,132,0.07
456,111,MOHAN KUMAR RAUT,National World Leader Party,163,0,163,0.08
457,111,VIJAY KUMAR PATLE,Janata Dal (United),109,1,110,0.06
458,111,ADVOCATE SATYAPRAKASH SHULKE,Madhya Pradesh Jan Vikas Party,113,1,114,0.06
459,111,AJEY VISHAL BISEN,Independent,2229,21,2250,1.13
460,111,DEEPAK PANCHESHWAR,Independent,288,3,291,0.15
461,111,DHANIRAM,Independent,300,1,301,0.15
462,111,BABBAN KHAN,Independent,205,1,206,0.1
463,111,MANISHA NANU VAIDYA,Independent,567,3,570,0.29
464,111,MAHENDRA SIHORE,Independent,246,0,246,0.12
465,111,RUPLAL KUTRAHE (SOSL WARKR),Independent,1103,0,1103,0.56
466,111,GYANSINGH EDPACHE,Independent,1145,2,1147,0.58
467,111,NOTA,None of the Above,521,13,534,0.27
468,108,BHAGAT SINGH NETAM,Bharatiya Janata Party,89118,473,89591,45.06
469,108,SANJAY UIKEY,Indian National Congress,88983,1159,90142,45.33
470,108,ASHOK MASIH DHURVE,Communist Party of India,2534,9,2543,1.28
471,108,FATTESINGH KAMLESH,Gondvana Gantantra Party,8578,68,8646,4.35
472,108,DILAN SINGH KODAPE,Independent,455,0,455,0.23
473,108,DEEPAK UIKEY,Independent,432,2,434,0.22
474,108,BUDHRAM DHURWAY,Independent,423,0,423,0.21
475,108,ROSHANI TILGAM,Independent,751,7,758,0.38
476,108,SONAL SIRSAM,Independent,1044,1,1045,0.53
477,108,SANJAY MASRAM,Independent,1318,2,1320,0.66
478,108,NOTA,None of the Above,3478,6,3484,1.75
479,94,KUNWAR SAURABH SINGH,Indian National Congress,70706,489,71195,35.58
480,94,PRANAY PRABHAT PANDEY (GUDDU BHAIYA),Bharatiya Janata Party,94428,389,94817,47.38
481,94,RAGHUNANDAN GOVIND PATEL,Bahujan Samaj Party,1605,5,1610,0.8
482,94,PINKY BARMAN D/o SUDAMA PRASAD BARMAN,Aapka Gantantra Party,331,2,333,0.17
483,94,PANKAJ MAURYA,Janata Dal (United),140,1,141,0.07
484,94,PHOOLCHAND PATEL,Indian Peoples Adhikar Party,162,0,162,0.08
485,94,BARE LAL RAI,Bhartiya Shakti Chetna Party,238,0,238,0.12
486,94,Dr. BALMUKUND SONI,Vastavik Bharat Party,877,0,877,0.44
487,94,SHANKAR MAHTO,Samajwadi Party,21538,60,21598,10.79
488,94,ANIL,Independent,273,2,275,0.14
489,94,NARESH LODHI,Independent,206,0,206,0.1
490,94,NAVNEET CHOURASIYA,Independent,848,6,854,0.43
491,94,RAKESH KUMAR SONKAR,Independent,322,1,323,0.16
492,94,RAJESH,Independent,991,0,991,0.5
493,94,VIJAY HALDKAR (EX-ARMY),Independent,1530,1,1531,0.77
494,94,SITA CHOUDHARI,Independent,1957,0,1957,0.98
495,94,SUBODH KUMAR JAIN / LALOO,Independent,1301,0,1301,0.65
496,94,GYANI YADAV,Independent,1231,0,1231,0.62
497,94,NOTA,None of the Above,463,2,465,0.23
498,174,GOPAL BHOSLE,Indian National Congress,96706,835,97541,46.55
499,174,MUKESH RAWAT,Bahujan Samaj Party,1826,4,1830,0.87
500,174,MURLI BHAWARA,Bharatiya Janata Party,104918,402,105320,50.27
501,174,SHERSINGH BHURIYA,Bharat Adivasi Party,1799,2,1801,0.86
502,174,ARJUN SINGH,Independent,692,1,693,0.33
503,174,SURAJ JAYS,Independent,728,5,733,0.35
504,174,NOTA,None of the Above,1605,3,1608,0.77
505,190,PREMSINGH PATEL,Bharatiya Janata Party,89446,579,90025,44.73
506,190,RAJAN MANDLOI,Indian National Congress,99763,1434,101197,50.28
507,190,DEEPAK DEVISINGH SENGAR,Bharat Adivasi Party,2204,2,2206,1.1
508,190,KARAN BURMAN MISTRI,Independent,838,2,840,0.42
509,190,PANDU SOLANKI,Independent,1095,1,1096,0.54
510,190,Sandeep Nargave,Independent,2182,8,2190,1.09
511,190,NOTA,None of the Above,3703,14,3717,1.85
512,182,NARENDRA PATEL,Indian National Congress,84228,740,84968,46.64
513,182,SACHIN BIRLA,Bharatiya Janata Party,90069,398,90467,49.66
514,182,TRILOK RATHOR,Bahujan Samaj Party,2928,14,2942,1.61
515,182,GANGA BAI,Independent,274,0,274,0.15
516,182,MOHANLAL SHAH,Independent,107,0,107,0.06
517,182,RAM KUMAR YADAV,Independent,139,0,139,0.08
518,182,SHANTILAL - AARVE,Independent,737,1,738,0.41
519,182,Shayam SHing RAwAt,Independent,1006,1,1007,0.55
520,182,NOTA,None of the Above,1534,8,1542,0.85
521,31,JAIVARDHAN SINGH,Indian National Congress,94803,935,95738,48.58
522,31,DHARMENDRA GAJRAMSINGH YADAV,Bahujan Samaj Party,2305,6,2311,1.17
523,31,HEERENDRA SINGH BUNTY PEELAGHATA,Bharatiya Janata Party,90834,399,91233,46.3
524,31,SANJEEV AHIRWAR,Aazad Samaj Party (Kanshi Ram),2445,6,2451,1.24
525,31,KETAN CHAUHAN,Independent,554,0,554,0.28
526,31,JAI SINGH RAGHOGARH,Independent,456,2,458,0.23
527,31,LAL SINGH LODHA,Independent,364,0,364,0.18
528,31,SAGAR SINGH KUSHWAH,Independent,690,0,690,0.35
529,31,HEERENDRA SINGH BANTI BANA,Independent,1153,3,1156,0.59
530,31,NOTA,None of the Above,2110,3,2113,1.07
531,88,PHUNDELAL SINGH MARKO,Indian National Congress,67105,915,68020,42.14
532,88,RAMESH,Communist Party of India (Marxist),1876,18,1894,1.17
533,88,HEERA SINGH SHYAM,Bharatiya Janata Party,63221,313,63534,39.36
534,88,ANIL SINGH DHURWEY,Gondvana Gantantra Party,13144,67,13211,8.18
535,88,AMIT KUMAR PADWAR,Bhartiya Shakti Chetna Party,3796,36,3832,2.37
536,88,AMRITLAL SONWANI,Vindhya Janta Party,520,4,524,0.32
537,88,ABHIJEET SINGH,Independent,575,6,581,0.36
538,88,CHHOTE,Independent,661,8,669,0.41
539,88,NARMADA SINGH,Independent,2683,37,2720,1.68
540,88,LAMMU SINGH,Independent,1093,7,1100,0.68
541,88,LALIT KUMAR SANT,Independent,1354,7,1361,0.84
542,88,NOTA,None of the Above,3978,7,3985,2.47
543,45,ASHISH KUMAR RAIKWAR,Bahujan Samaj Party,1608,6,1614,0.91
544,45,UMA KUSHWAHA,Aam Aadmi Party,588,2,590,0.33
545,45,NITENDRA BRAJENDRA SINGH RATHORE,Indian National Congress,85431,308,85739,48.35
546,45,DR. SHISHUPAL YADAV,Bharatiya Janata Party,83769,139,83908,47.32
547,45,AHIRWAR GOVINDDAS FOUJI,Aazad Samaj Party (Kanshi Ram),1450,1,1451,0.82
548,45,MINEE YADAV,Samajwadi Party,326,3,329,0.19
549,45,PYARE LAL KEWAT,Jan Adhikar Party,177,0,177,0.1
550,45,RAJPAL SINGH CHOHAN,Sainik Samaj Party,171,0,171,0.1
551,45,AHIRWAR GYANCHANDRA,Independent,265,0,265,0.15
552,45,GOVIND YADAV,Independent,298,0,298,0.17
553,45,DILEEP JAIN YOGI,Independent,1034,0,1034,0.58
554,45,DHARMENDRA KUMAR PAL,Independent,576,0,576,0.32
555,45,RAMESH KUSHWAHA,Independent,360,0,360,0.2
556,45,NOTA,None of the Above,821,2,823,0.46
557,24,KAILASH KUSHWAH,Indian National Congress,99068,671,99739,51.57
558,24,PRADHUMNA VERMA (BACHAURA),Bahujan Samaj Party,37064,197,37261,19.27
559,24,SURESH DHAKAD RANTHKHEDA,Bharatiya Janata Party,49966,292,50258,25.99
560,24,VINOD KUMAR,Bahujan Mukti Party,714,1,715,0.37
561,24,SIDDHAM SINGH KHEMARIYA,Aazad Samaj Party (Kanshi Ram),285,1,286,0.15
562,24,KALYAN KUSWAH,Independent,154,0,154,0.08
563,24,KAILASH NARAYAN PARIHAR,Independent,161,0,161,0.08
564,24,GIRRAJ,Independent,112,0,112,0.06
565,24,NARESH DHAKAD,Independent,159,1,160,0.08
566,24,BABOOLAL GORAKH (JATAV),Independent,180,1,181,0.09
567,24,BRAJESH DHAKAR,Independent,170,0,170,0.09
568,24,MAHENDRA DHENGAR,Independent,484,1,485,0.25
569,24,RAMESHWAR VERMA,Independent,572,0,572,0.3
570,24,SATENDRA DHAKAD,Independent,740,0,740,0.38
571,24,HAKIM SINGH VERMA,Independent,858,0,858,0.44
572,24,NOTA,None of the Above,1551,5,1556,0.8
573,139,THAKURDAS NAGWANSHI,Bharatiya Janata Party,106981,391,107372,55.09
574,139,PRATIBHA AHIRWAR,Bahujan Samaj Party,3357,15,3372,1.73
575,139,VEERENDRA BELWANSHI,Indian National Congress,76193,656,76849,39.43
576,139,KADORI LAL GOLIYA,Republican Party of India (A),1150,1,1151,0.59
577,139,MONU MEHRA,Gana Suraksha Party,457,0,457,0.23
578,139,SUNIL PAWAR,Right to Recall Party,495,0,495,0.25
579,139,NARENDRA PATHARIYA,Independent,1612,9,1621,0.83
580,139,YUGAL KISHOR,Independent,731,1,732,0.38
581,139,NOTA,None of the Above,2849,10,2859,1.47
582,26,ARVIND SINGH LODHI,Indian National Congress,98551,795,99346,43.01
583,26,PREETAM LODHI,Bharatiya Janata Party,120753,475,121228,52.48
584,26,SANTSINGH ADIWASI,Bahujan Samaj Party,2200,8,2208,0.96
585,26,D.S. CHAUHAN (ADVOCATE),Jan Adhikar Party,240,0,240,0.1
586,26,CHANDRAPAL SiNGH YADAV,Janata Dal (United),131,1,132,0.06
587,26,RAJEEV YADAV,Samajwadi Party,369,3,372,0.16
588,26,RAM SINGH PAL,Rashtriya Samaj Paksha,105,0,105,0.05
589,26,DAU AMAR SINGH,Independent,106,0,106,0.05
590,26,ARVIND LODHI (MUHARI),Independent,319,2,321,0.14
591,26,KRiSHNAPAL SiNGH CHOOHAN,Independent,137,1,138,0.06
592,26,JASRATH JATAV,Independent,598,4,602,0.26
593,26,DUAARIKA PARiSAD YADAV,Independent,209,0,209,0.09
594,26,MAHESH DONGAR,Independent,396,3,399,0.17
595,26,RAKESH LODHI,Independent,435,0,435,0.19
596,26,SANTOSH KUMAR SHARMA,Independent,1050,1,1051,0.46
597,26,SHOBREN SiNGH BUNDELA,Independent,1921,0,1921,0.83
598,26,NOTA,None of the Above,2173,3,2176,0.94
599,195,KOMALSINH BAPUSINH DAMOR,Aam Aadmi Party,7399,41,7440,3.23
600,195,NIRMALA DILEEPSINGH BHURIA,Bharatiya Janata Party,100787,725,101512,44.12
601,195,RAMCHANDRA JAVRA SOLANKI,Bahujan Samaj Party,2509,8,2517,1.09
602,195,VALSINGH MAIDA,Indian National Congress,95051,814,95865,41.67
603,195,Er. BALUSINGH GAMAD,Bharat Adivasi Party,15486,125,15611,6.79
604,195,RAMESHVAR SINGAR,Janata Dal (United),998,3,1001,0.44
605,195,PREMSINGH BHURIYA,Independent,799,3,802,0.35
606,195,SATAN KATARA,Independent,1752,0,1752,0.76
607,195,NOTA,None of the Above,3557,5,3562,1.55
608,58,PRAHLAD LODHI,Bharatiya Janata Party,106126,285,106411,49.76
609,58,PANDIT MUKESH NAYAK,Indian National Congress,83610,758,84368,39.45
610,58,HEMANT RISHIRAJ SINGH,Bahujan Samaj Party,3305,9,3314,1.55
611,58,ASHISH KUMAR KUSHWAHA,Jan Adhikar Party,427,0,427,0.2
612,58,BEERAN PATEL,Rashtriya Jansanchar Dal,278,0,278,0.13
613,58,BHARAT LAL PATEL,Vastavik Bharat Party,267,4,271,0.13
614,58,RAJANI YADAV,Samajwadi Party,2889,7,2896,1.35
615,58,RAMPAL SINGH GONDELA,Bhartiya Ganrajya Party,4100,9,4109,1.92
616,58,ANAND KUMAR VISHWAKARMA,Independent,844,0,844,0.39
617,58,ASHISH,Independent,455,0,455,0.21
618,58,PRAHALAD,Independent,732,1,733,0.34
619,58,PRAHLAD KUMAR PRAJAPATI,Independent,569,1,570,0.27
620,58,PRAHLAD LODHI,Independent,676,1,677,0.32
621,58,RAMMOORTI CHOURASHIYA,Independent,926,0,926,0.43
622,58,VIJAY KUMAR SONI,Independent,1678,0,1678,0.78
623,58,HARI LAL CHOUDHARY RETIRED T.I.,Independent,3383,4,3387,1.58
624,58,NOTA,None of the Above,2496,2,2498,1.17
625,54,RAO BRAJENDRA SINGH,Indian National Congress,63819,625,64444,34.4
626,54,RAMBAI GOVIND SINGH,Bahujan Samaj Party,29233,106,29339,15.66
627,54,LAKHAN PATEL,Bharatiya Janata Party,82246,357,82603,44.09
628,54,KALLAN KURMI,Bhartiya Shakti Chetna Party,2605,8,2613,1.39
629,54,PRIYANKA VIKASH ROSHAN(BHEEM ARMY),Aazad Samaj Party (Kanshi Ram),479,1,480,0.26
630,54,DR. MANOJ VISHWAKARMA,Bharatiya Jan Morcha Party,167,1,168,0.09
631,54,LEELADHAR KUSHWAHA,Jan Adhikar Party,622,2,624,0.33
632,54,CHURAMAN AHIRWAL,Independent,233,1,234,0.12
633,54,DHANI BHAIYA,Independent,275,0,275,0.15
634,54,ER. NEELESH KUMAR PATEL(KURMI),Independent,165,0,165,0.09
635,54,BHAGIRATH AHIRWAR,Independent,212,0,212,0.11
636,54,RAO BHUSHANSING,Independent,227,2,229,0.12
637,54,MUKESH RAJAK,Independent,566,0,566,0.3
638,54,MAJOR GENERAL(DR) RAJENDRA SINGH THAKUR,Independent,1708,3,1711,0.91
639,54,VIKRAM SINGH,Independent,568,2,570,0.3
640,54,SANJAY SETH SADGUWAN(BHOLU),Independent,1405,1,1406,0.75
641,54,SANTOSH SONI,Independent,1001,0,1001,0.53
642,54,NOTA,None of the Above,708,4,712,0.38
643,95,AJAY VISHNOI,Bharatiya Janata Party,112735,488,113223,54.21
644,95,TAN SINGH THAKUR (TANNU BHAIYA),Bahujan Samaj Party,3222,14,3236,1.55
645,95,NEELESH AWASTHI,Indian National Congress,82151,817,82968,39.72
646,95,VIJAY MOHAN,Aam Aadmi Party,1456,4,1460,0.7
647,95,ARJUN SINGH,Bhartiya Shakti Chetna Party,419,2,421,0.2
648,95,PRAHLAD SINGH LODHI,Bharatiya Sabhyata Party,96,0,96,0.05
649,95,LEELADHAR JHARIYA,Indian Peoples Adhikar Party,115,0,115,0.06
650,95,SHANTI BAI KOL,Aadim Samaj Party,112,0,112,0.05
651,95,ANIL SINGH RAJPOOT,Independent,129,2,131,0.06
652,95,ARVIND KUMAR,Independent,116,0,116,0.06
653,95,OM PRAKASH SINGH,Independent,138,1,139,0.07
654,95,KAMLESH KUMAR PATEL(BHAIYA JI),Independent,299,2,301,0.14
655,95,DINESH,Independent,379,1,380,0.18
656,95,NEELESH KUMAR GARG,Independent,832,1,833,0.4
657,95,RAJKUMAR TAMRAKAR,Independent,432,0,432,0.21
658,95,RADHESHYAM,Independent,1699,1,1700,0.81
659,95,VIRENDRA SINGH,Independent,1656,0,1656,0.79
660,95,SEETA RAM KUMHAR (GUDDO BHAIYA),Independent,236,0,236,0.11
661,95,SURAJ MAHAWAT,Independent,766,1,767,0.37
662,95,NOTA,None of the Above,536,5,541,0.26
663,110,Madhu Bhau Bhagat,Indian National Congress,99893,1099,100992,51.81
664,110,KAWRE RAMKISHOR (NANO),Bharatiya Janata Party,74762,282,75044,38.5
665,110,SHIVSHANKAR YADAV,Aam Aadmi Party,1399,5,1404,0.72
666,110,KANKAR MUNJARE,Gondvana Gantantra Party,13447,95,13542,6.95
667,110,Omprakash Patel,Independent,308,0,308,0.16
668,110,JEEWANSIH TEKAM,Independent,239,2,241,0.12
669,110,PUSHPENDRA PATLE,Independent,268,1,269,0.14
670,110,BRAJLAL TEKAM,Independent,417,1,418,0.21
671,110,MUKESH BAGHELE,Independent,693,2,695,0.36
672,110,NOTA,None of the Above,2021,6,2027,1.04
673,127,JYOTI DEHARIYA,Bharatiya Janata Party,85357,702,86059,46.57
674,127,SOHANLAL BALMIK,Indian National Congress,87149,1078,88227,47.75
675,127,JYOTI DEHARIYA,Republican Party of India (A),1510,3,1513,0.82
676,127,SATEESH KUMAR NAGWANSHI,Gondvana Gantantra Party,726,8,734,0.4
677,127,Ashok Barasiya,Independent,196,0,196,0.11
678,127,KAILASH NAGALKAR (SONU),Independent,207,1,208,0.11
679,127,JYOTI,Independent,355,2,357,0.19
680,127,"TUKARAM DURGE ""MASAB""",Independent,458,4,462,0.25
681,127,RUPESH BALMIK,Independent,228,0,228,0.12
682,127,''SANTOSHI DEHARIYA'',Independent,1693,13,1706,0.92
683,127,SAGAR BELWANSHI,Independent,591,0,591,0.32
684,127,SURESH BUNKAR (SATANKAR),Independent,1443,3,1446,0.78
685,127,NOTA,None of the Above,3043,6,3049,1.65
686,189,CHANDRABHAGA KIRADE (BUAJI ),Indian National Congress,82790,949,83739,41.91
687,189,DAYARAM JAMSINGH DAWAR,Aam Aadmi Party,2393,16,2409,1.21
688,189,SHYAM BARDE,Bharatiya Janata Party,96698,483,97181,48.64
689,189,RAMESH BHANGI CHOUHAN,Independent,12880,70,12950,6.48
690,189,NOTA,None of the Above,3509,12,3521,1.76
691,60,Brijendra Pratap Singh,Bharatiya Janata Party,96283,385,96668,51.15
692,60,Bharat Milan Pandey,Indian National Congress,77747,1011,78758,41.67
693,60,Vimla Ahirwar,Bahujan Samaj Party,2843,12,2855,1.51
694,60,Lodhi Mahendra Pal Verma,Samajwadi Party,2870,7,2877,1.52
695,60,Mevalal Ahirwar,Aazad Samaj Party (Kanshi Ram),1137,1,1138,0.6
696,60,Jigyasa Kanojiya,Independent,879,2,881,0.47
697,60,Nand Kumar Vyas,Independent,484,0,484,0.26
698,60,Firoj Khan,Independent,364,0,364,0.19
699,60,Mohammad Ikram,Independent,635,0,635,0.34
700,60,Rajesh Shrivastav,Independent,1056,0,1056,0.56
701,60,Sonelal Prajapati,Independent,911,2,913,0.48
702,60,NOTA,None of the Above,2364,0,2364,1.25
703,128,NEELESH PUSARAM UIKEY,Indian National Congress,90231,713,90944,49.01
704,128,PRAKASH BHAU UIEKEY,Bharatiya Janata Party,80213,274,80487,43.37
705,128,SUNIL RATIRAM ERPACHI,Gondvana Gantantra Party,5048,21,5069,2.73
706,128,GONDIYA BHALAVI,Independent,1716,6,1722,0.93
707,128,RAMSINGH UIKEY,Independent,490,1,491,0.26
708,128,RAMAJI UIKEY,Independent,633,3,636,0.34
709,128,WASUDEO KUMRE,Independent,1800,2,1802,0.97
710,128,SANJEEV PARTETEE,Independent,1161,0,1161,0.63
711,128,NOTA,None of the Above,3266,1,3267,1.76
712,178,CHAYA MORE,Bharatiya Janata Party,122898,434,123332,54.78
713,178,MANOJ SOLANKI,Bahujan Samaj Party,1734,10,1744,0.77
714,178,RUPALI NANDU BARE,Indian National Congress,93887,629,94516,41.98
715,178,CHHAYA MORE,Independent,1815,6,1821,0.81
716,178,MAMTA MORE,Independent,1141,8,1149,0.51
717,178,NOTA,None of the Above,2584,6,2590,1.15
718,101,MISS ASHA GOTIYA,Bahujan Samaj Party,3788,24,3812,1.84
719,101,PANKAJ PATHAK,Aam Aadmi Party,809,15,824,0.4
720,101,RAJESH PATEL,Indian National Congress,77672,858,78530,37.81
721,101,SUSHIL KUMAR TIWARI (INDU BHAIYA),Bharatiya Janata Party,118473,598,119071,57.33
722,101,ANITA OMPRAKASH KEWAT (BANTI) MOOLNIWASI,Bahujan Mukti Party,922,1,923,0.44
723,101,MAHENDRA YADAV,Bhartiya Shakti Chetna Party,419,2,421,0.2
724,101,ANIL KUMAR AHIRWAR,Independent,309,0,309,0.15
725,101,GAURI SHANKAR TIWARI (R.F.O),Independent,900,3,903,0.43
726,101,BRAJESH (MAHARAJ),Independent,691,2,693,0.33
727,101,RUCHI SISODIYA (ALIAS) RUCHI MAHADEV,Independent,408,1,409,0.2
728,101,NOTA,None of the Above,1792,20,1812,0.87
729,106,CHAINSINGH WARKADE,Indian National Congress,98741,903,99644,45.73
730,106,FAGGAN SINGH KULASTE,Bharatiya Janata Party,89676,245,89921,41.27
731,106,DEVENDRA MARAVI 'BHOI',Gondvana Gantantra Party,19197,67,19264,8.84
732,106,MANMOHAN SINGH GOUTHARIYA,Kranti Janshakti Party,2876,8,2884,1.32
733,106,ZANYFAR MARY,Independent,1832,4,1836,0.84
734,106,NOTA,None of the Above,4344,2,4346,1.99
735,46,ANIL JAIN,Bharatiya Janata Party,53932,254,54186,33.43
736,46,AMIT RAI JIJOURA,Indian National Congress,36634,395,37029,22.84
737,46,AWADHESH PRATAP SINGH RATHORE,Bahujan Samaj Party,13213,112,13325,8.22
738,46,MEERA DEEPAK YADAV,Samajwadi Party,32552,118,32670,20.15
739,46,ANIL,Independent,351,0,351,0.22
740,46,ANITA KUSHWAHA,Independent,256,0,256,0.16
741,46,ABHISHEK RESTRI LEKHAK,Independent,215,1,216,0.13
742,46,AVDHESH YADAV`,Independent,135,0,135,0.08
743,46,DEEPAK YADAV,Independent,861,1,862,0.53
744,46,DEVENDRA YADAV,Independent,410,1,411,0.25
745,46,NANDRAM KUSHWAHA,Independent,18799,28,18827,11.61
746,46,MAITHALI SHARAN,Independent,274,0,274,0.17
747,46,RAJNEESH PATERIYA,Independent,1372,25,1397,0.86
748,46,RAMESH PRASAD PATEL,Independent,437,0,437,0.27
749,46,DOCTOR RAMADHAR VASHISTH,Independent,564,0,564,0.35
750,46,NOTA,None of the Above,1165,1,1166,0.72
751,179,GENDU BAI,Indian National Congress,67949,646,68595,33.18
752,179,DILIP KASADEKAR,Bahujan Samaj Party,1665,14,1679,0.81
753,179,MANJU RAJENDRA DADU,Bharatiya Janata Party,112724,676,113400,54.85
754,179,RAVINDRA BUDHA SONWANE,Vanchit Bahujan Aaghadi,1746,10,1756,0.85
755,179,BILARSINGH JAMRA,Independent,16294,71,16365,7.92
756,179,RATILAL BHAULAL CHILATRE,Independent,2618,14,2632,1.27
757,179,NOTA,None of the Above,2297,6,2303,1.11
758,229,UMRAO SINGH GURJAR,Indian National Congress,77891,1116,79007,41.77
759,229,DILIP SINGH PARIHAR,Bharatiya Janata Party,104541,749,105290,55.67
760,229,DURGAPRASAD JATAV,Bahujan Samaj Party,742,6,748,0.4
761,229,IMRAN HUSAIN,Social Democratic Party Of India,404,1,405,0.21
762,229,GOVIND KUMAR RANVA,Aazad Samaj Party (Kanshi Ram),450,1,451,0.24
763,229,TULSIRAM MEGHWAL,Independent,181,1,182,0.1
764,229,RAJESH LALWANI ADVOCATE,Independent,288,5,293,0.15
765,229,SHYAM SUNDAR BAIRAGI,Independent,280,0,280,0.15
766,229,SURAJ YADAV,Independent,649,1,650,0.34
767,229,NOTA,None of the Above,1816,24,1840,0.97
768,40,ARVIND TOMAR,Aam Aadmi Party,2091,33,2124,1.25
769,40,Er. PRADEEP LARIYA,Bharatiya Janata Party,87647,555,88202,52.02
770,40,LATORI PRASAD SURYAVANSHI,Bahujan Samaj Party,1291,10,1301,0.77
771,40,ADVOCATE SURENDRA CHOUDHARY,Indian National Congress,72943,847,73790,43.52
772,40,DHARMENDRA AHIRWAR,Aazad Samaj Party (Kanshi Ram),1410,12,1422,0.84
773,40,SURESH DHANAK,Bhartiya Shakti Chetna Party,426,3,429,0.25
774,40,HARAVIND DHANUK,Akhil Bhartiya Aarakshit Samaj Party,342,2,344,0.2
775,40,AKASH AHIRWAR,Independent,263,0,263,0.16
776,40,KOMAL Chadar,Independent,450,2,452,0.27
777,40,NOTA,None of the Above,1206,15,1221,0.72
778,119,PRAHLAD SINGH PATEL,Bharatiya Janata Party,109196,1030,110226,56.33
779,119,MAHESH PRASAD CHOUDHARY,Bahujan Samaj Party,1310,21,1331,0.68
780,119,LAKHAN SINGH PATEL,Indian National Congress,77101,1815,78916,40.33
781,119,MASTRAM LODHI,Bhartiya Shakti Chetna Party,923,1,924,0.47
782,119,RAMBAI THAKUR,Gana Suraksha Party,363,4,367,0.19
783,119,SHIVRAJ SINGH GOUTAM,Aazad Samaj Party (Kanshi Ram),437,2,439,0.22
784,119,M. GAJANFAR,Independent,818,1,819,0.42
785,119,SAPAN SHRIDHAR,Independent,361,1,362,0.19
786,119,NOTA,None of the Above,2256,27,2283,1.17
787,160,GIRISH BHANDARI,Indian National Congress,80328,841,81169,40.4
788,160,BADREELAL PATEL,Bahujan Samaj Party,1612,13,1625,0.81
789,160,MOHAN SHARMA,Bharatiya Janata Party,112207,877,113084,56.29
790,160,HEMANT SHARMA,Aam Aadmi Party,1120,4,1124,0.56
791,160,PREM SINGH PARIHAR,Bhartiya Shakti Chetna Party,230,0,230,0.11
792,160,BHARAT SINGH MEENA,Aazad Samaj Party (Kanshi Ram),640,5,645,0.32
793,160,D.K. KUSHWAH,Independent,375,6,381,0.19
794,160,DURGAPRASAD BHILALA,Independent,440,4,444,0.22
795,160,MOHAN DADA,Independent,286,7,293,0.15
796,160,RADHE SHYAM,Independent,475,1,476,0.24
797,160,VISHAL SONI (ADVOCATE),Independent,331,1,332,0.17
798,160,NOTA,None of the Above,1082,6,1088,0.54
799,151,MANOJ SHUKLA,Indian National Congress,99289,694,99983,43.38
800,151,MUKESH GOUR,Bahujan Samaj Party,1067,26,1093,0.47
801,151,RAISA BEGAM MALIK,Aam Aadmi Party,653,7,660,0.29
802,151,VISHVAS SARANG,Bharatiya Janata Party,123488,1064,124552,54.05
803,151,AJAY PATEL,Bhartiya Gan Varta Party,401,1,402,0.17
804,151,AMINUL HAQUE SIDDIQUI,Communist Party of India,399,4,403,0.17
805,151,BALRAM SINGH TAUMAR,Bhartiya Shakti Chetna Party,114,2,116,0.05
806,151,MUFTI ATA URHMAN KHAN,Social Democratic Party Of India,88,0,88,0.04
807,151,VIRENDRA,National World Leader Party,117,1,118,0.05
808,151,ARJUN ARYA,Independent,52,0,52,0.02
809,151,MO. ATEEQ,Independent,77,1,78,0.03
810,151,ASIF KHAN,Independent,58,1,59,0.03
811,151,IZHARUL HASAN,Independent,100,2,102,0.04
812,151,IBRAHIM KHAN,Independent,69,1,70,0.03
813,151,MOHD. JAVED,Independent,106,0,106,0.05
814,151,ZAHID KHAN,Independent,364,0,364,0.16
815,151,MAQSOOD,Independent,421,0,421,0.18
816,151,MANOJ SHUKLA,Independent,115,1,116,0.05
817,151,MO RASHEED URF BABU MASTAN,Independent,372,5,377,0.16
818,151,MOHD RASHID,Independent,179,2,181,0.08
819,151,SHAMSHUL HASAN,Independent,178,1,179,0.08
820,151,SHADAB MIYA,Independent,27,0,27,0.01
821,151,MOHD. SAJID,Independent,32,0,32,0.01
822,151,NOTA,None of the Above,854,24,878,0.38
823,64,NAGENDRA SINGH,Bharatiya Janata Party,70240,472,70712,38.59
824,64,YADVENDRA SINGH,Bahujan Samaj Party,52994,349,53343,29.11
825,64,Dr. RASHMI SINGH,Indian National Congress,49470,812,50282,27.44
826,64,DILEEP BUNKAR,Bharatiya Jan Morcha Party,573,2,575,0.31
827,64,RAMSHARN KUSHWHA,Samajwadi Party,1003,6,1009,0.55
828,64,"RAVENDRA PANDEY ""RAUND""",Janata Congress,111,1,112,0.06
829,64,SURAJ SINGH KONI,Vindhya Janta Party,1982,21,2003,1.09
830,64,SANDEEP KUSHWAHA (SANDEEP BAIYA),Bhartiya Shakti Chetna Party,412,3,415,0.23
831,64,NAGENDRA SINGH,Independent,255,1,256,0.14
832,64,MULNIWASI - SMT - NEELU JAISWAL,Independent,311,1,312,0.17
833,64,PREMLAL KUSHWAHA,Independent,431,4,435,0.24
834,64,BIRENDRA SINGH,Independent,442,1,443,0.24
835,64,RAJU TIWARI,Independent,684,1,685,0.37
836,64,SURENDRA KUMAR DWIVEDI,Independent,1054,4,1058,0.58
837,64,NOTA,None of the Above,1604,4,1608,0.88
838,212,Ad. Karan Singh Gurjar,Bahujan Samaj Party,938,5,943,0.53
839,212,DR. TEJBAHADUR SINGH CHAUHAN,Bharatiya Janata Party,93187,365,93552,52.18
840,212,DILIP SINGH GURJAR,Indian National Congress,77092,533,77625,43.3
841,212,SUBODH KRISHNA SWAMY,Aam Aadmi Party,1488,7,1495,0.83
842,212,NARENDRA CHOUHAN,Aazad Samaj Party (Kanshi Ram),1975,2,1977,1.1
843,212,NARENDRA PARMAR,Akhand Bharat Samrajya Party,316,1,317,0.18
844,212,ANAND KUMAR GOTHARWAL,Independent,210,0,210,0.12
845,212,Jagdish chandra Prajapati,Independent,448,1,449,0.25
846,212,LOKENDRA MEHTA,Independent,1588,9,1597,0.89
847,212,NOTA,None of the Above,1122,4,1126,0.63
848,93,MANOJ BAJHAL ADVOCATE,Bahujan Samaj Party,2161,17,2178,1.24
849,93,"MITHLESH JAIN, ADVOCATE",Indian National Congress,64105,644,64749,36.73
850,93,SUNIL MISHRA,Aam Aadmi Party,2214,26,2240,1.27
851,93,SANDEEP SHRIPRASAD JAISWAL,Bharatiya Janata Party,89081,571,89652,50.85
852,93,ARUN KUMAR PATEL,Peoples Party of India (Democratic),618,4,622,0.35
853,93,GULAB BHAI BANSKAR,Lok Janshakti Party(Ram Vilas),278,3,281,0.16
854,93,DR. B. K. PATEL,Pichhara Samaj Party United,676,3,679,0.39
855,93,MANISH BAIN,Aapka Gantantra Party,214,4,218,0.12
856,93,MOHAMMAD JAVED (O.B.C.),Aazad Samaj Party (Kanshi Ram),398,3,401,0.23
857,93,RAJUKUMAR BAKSHI SENIOR ADVOCATE,Indian Peoples Adhikar Party,139,2,141,0.08
858,93,VINDESHWARI PATEL,Loktantrik Samajwadi Party,277,3,280,0.16
859,93,ADV. SANDEEP NAYAK,Samajwadi Party,393,3,396,0.22
860,93,"AKASH PATHAK, BACHHA BHAIYA",Independent,656,4,660,0.37
861,93,JYOTI VINAY DIXIT,Independent,8261,36,8297,4.71
862,93,RAKESH GOSWAMI (BHAIYA JI),Independent,596,0,596,0.34
863,93,VIVEK PATHAK (GOVIND SARKAR),Independent,1367,1,1368,0.78
864,93,SAGAR TOMAR,Independent,347,2,349,0.2
865,93,SANTOSH SHUKLA,Independent,2200,26,2226,1.26
866,93,NOTA,None of the Above,955,14,969,0.55
867,34,BRAJENDRA SINGH YADAV,Bharatiya Janata Party,76839,223,77062,44.99
868,34,MOHAN SINGH YADAV,Bahujan Samaj Party,15270,70,15340,8.96
869,34,RAO YADVENDRA SINGH,Indian National Congress,71020,620,71640,41.83
870,34,MUKESH LODHI,Aazad Samaj Party (Kanshi Ram),3290,10,3300,1.93
871,34,OMKAR SINGH,Independent,169,0,169,0.1
872,34,GENDRAJ SINGH YADAV,Independent,71,0,71,0.04
873,34,DAULAT SINGH LODHI,Independent,98,0,98,0.06
874,34,BANTI RAI BABA,Independent,139,0,139,0.08
875,34,BHUPENDRA SINGH YADAV,Independent,211,2,213,0.12
876,34,RAJPAL SINGH,Independent,136,0,136,0.08
877,34,RANI BAI JATAV,Independent,205,0,205,0.12
878,34,RAM DAYAL SINGH,Independent,491,1,492,0.29
879,34,SALMAN KHAN,Independent,514,1,515,0.3
880,34,SHREYANSH,Independent,625,3,628,0.37
881,34,NOTA,None of the Above,1259,9,1268,0.74
882,129,INDALRAO KHATARKAR,Bahujan Samaj Party,2224,33,2257,1.21
883,129,CHANDRASHEKHAR DESHMUKH,Bharatiya Janata Party,95590,476,96066,51.38
884,129,Sukhdeo Panse,Indian National Congress,80246,978,81224,43.44
885,129,KRIPAL SINGH SISODIYA,Samajwadi Party,1168,2,1170,0.63
886,129,JANARDHN (J.D.) PATIL,Bahujan Mukti Party,451,4,455,0.24
887,129,MANISH DHOTE,National World Leader Party,516,0,516,0.28
888,129,ENGINEER CHAITANYA PAWAR,Independent,187,1,188,0.1
889,129,"DINESH SAHU ""OPTION""",Independent,191,2,193,0.1
890,129,PALASH KADWE (Pawar),Independent,930,15,945,0.51
891,129,Dr. MEENA RAMESH GAVHADE,Independent,750,2,752,0.4
892,129,RITESH RAMENLAL KAWDE,Independent,944,3,947,0.51
893,129,Er. RUPALI KHADE,Independent,761,2,763,0.41
894,129,NOTA,None of the Above,1481,7,1488,0.8
895,6,DINESH GURJAR,Indian National Congress,72409,1286,73695,43.2
896,6,RAGHURAJ SINGH KANSANA,Bharatiya Janata Party,53372,452,53824,31.55
897,6,RAMESH UPADHYAY,Aam Aadmi Party,1901,31,1932,1.13
898,6,RAKESH RUSTAM SINGH,Bahujan Samaj Party,36922,245,37167,21.79
899,6,CHITRALEKHA KUSHWAHA,Jan Adhikar Party,297,0,297,0.17
900,6,BHAGEERATH SINGH RATHOR,Parivartan Samaj Party,219,2,221,0.13
901,6,RAKESH KUSHWAH TALPURA WALE,Samajwadi Party,75,0,75,0.04
902,6,SHASHEE KUMAR PACHORI(JATAV),Aazad Samaj Party (Kanshi Ram),187,1,188,0.11
903,6,ANOOP SIKARWAR,Independent,67,1,68,0.04
904,6,JITENDRA,Independent,65,0,65,0.04
905,6,BHARAT SINGH,Independent,185,1,186,0.11
906,6,MANOJ,Independent,124,0,124,0.07
907,6,DR. MURARI LAL MITTAL,Independent,772,8,780,0.46
908,6,RAKESH,Independent,122,0,122,0.07
909,6,RAJENDRA AGRAWAL,Independent,152,0,152,0.09
910,6,RAM SUNDAR,Independent,488,0,488,0.29
911,6,SAGAR PATHAK,Independent,544,1,545,0.32
912,6,SUNIL SINGH,Independent,287,0,287,0.17
913,6,NOTA,None of the Above,372,10,382,0.22
914,12,RAKESH SHUKLA,Bharatiya Janata Party,86510,643,87153,48.01
915,12,RAJBEER,Bahujan Samaj Party,19416,90,19506,10.75
916,12,RAHUL SINGH BHADOURIA,Indian National Congress,64283,860,65143,35.89
917,12,Satendra Bhadoriya (Lovely),Aam Aadmi Party,1800,25,1825,1.01
918,12,DEV NAGAR (DEVENDRA NAGAR),Vikas India Party,314,1,315,0.17
919,12,BHUPENDRA KARANA (GURJAR),Aazad Samaj Party (Kanshi Ram),4428,60,4488,2.47
920,12,ADVOCATE RAKESH SINGH KAURAV,Loktantrik Samajwadi Party,317,1,318,0.18
921,12,RaJeshwar Singh,Jan Adhikar Party,245,0,245,0.13
922,12,SHIV PRATAP SINGH BHADORIYA,Sapaks Party,328,2,330,0.18
923,12,JAY SINGH,Independent,91,0,91,0.05
924,12,NARESH SINGH,Independent,139,0,139,0.08
925,12,MANISH AGRAWAL,Independent,206,0,206,0.11
926,12,ROHIT OJHA,Independent,155,0,155,0.09
927,12,SATENDRA SINGH,Independent,362,0,362,0.2
928,12,SITARAM,Independent,349,1,350,0.19
929,12,NOTA,None of the Above,904,1,905,0.5
930,71,PANDIT UMESH TRIPATHI GHUREHATA,Aam Aadmi Party,3721,26,3747,2.41
931,71,PRADEEP PATEL,Bharatiya Janata Party,69860,259,70119,45.14
932,71,BHAIYALAL KOL,Bahujan Samaj Party,12354,42,12396,7.98
933,71,SUKHENDRA SINGH BANNA,Indian National Congress,62393,552,62945,40.52
934,71,NOOR MOHAMMAD,Samajwadi Party,989,2,991,0.64
935,71,RAM BAHADUR PATEL,Peoples Party of India (Democratic),274,2,276,0.18
936,71,SURESH KUMAR SEN,Bhartiya Shakti Chetna Party,337,0,337,0.22
937,71,DADAN PRASAD MISHRA,Independent,268,0,268,0.17
938,71,DHRUV NARAYAN MISHRA,Independent,349,0,349,0.22
939,71,BRAHM DATTA MISHRA,Independent,969,2,971,0.63
940,71,MEHARUNISHA,Independent,529,3,532,0.34
941,71,SUSHEELA GUPTA,Independent,935,2,937,0.6
942,71,NOTA,None of the Above,1465,8,1473,0.95
943,90,Smt. USHA KOL,Aam Aadmi Party,5912,24,5936,3.05
944,90,TILAK RAJ SINGH,Indian National Congress,59996,828,60824,31.26
945,90,MEENA SINGH,Bharatiya Janata Party,85568,521,86089,44.25
946,90,ANNU KOL,Sapaks Party,1707,20,1727,0.89
947,90,Rajkumar Baiga,Vindhya Janta Party,818,10,828,0.43
948,90,Rajendra Baiga,Peoples Party of India (Democratic),2317,6,2323,1.19
949,90,RADHE SHYAM KUKODIYA,Gondvana Gantantra Party,28726,113,28839,14.82
950,90,SAMBHU SINGH,Bhartiya Shakti Chetna Party,1151,3,1154,0.59
951,90,Chhatrapati,Independent,1671,11,1682,0.86
952,90,SEEMA SINGH,Independent,1745,6,1751,0.9
953,90,NOTA,None of the Above,3393,9,3402,1.75
954,73,ENGINEER NARENDRA PRAJAPATI,Bharatiya Janata Party,78429,325,78754,50.47
955,73,SMT. BABITA SAKET,Indian National Congress,46094,748,46842,30.02
956,73,RAMAYAN SAKET,Bahujan Samaj Party,22837,58,22895,14.67
957,73,VARUN AMBEDKAR (VICKY),Aam Aadmi Party,1102,9,1111,0.71
958,73,GANPATI BANSAL,Aadim Samaj Party,242,0,242,0.16
959,73,JOKHULAL PRAJAPATI,Peoples Party of India (Democratic),224,0,224,0.14
960,73,PRITI VARMA (SAKET),Samajwadi Party,1399,9,1408,0.9
961,73,Mewalal Prajapati,Bhagidari Party(P),192,1,193,0.12
962,73,RAMESH SAKET,Bhartiya Shakti Chetna Party,324,2,326,0.21
963,73,RAMESH CHANDRA,Independent,764,2,766,0.49
964,73,RAJNARAYAN,Independent,544,1,545,0.35
965,73,SHIVDAS KORI,Independent,789,2,791,0.51
966,73,NOTA,None of the Above,1942,5,1947,1.25
967,224,YASHPALSINGH SISODIYA,Bharatiya Janata Party,102659,608,103267,48.47
968,224,VIPIN JAIN,Indian National Congress,104137,1179,105316,49.43
969,224,SUNITA DR. KAILASH GARG,Bahujan Samaj Party,1031,8,1039,0.49
970,224,ASLAM KHAN,Independent,243,0,243,0.11
971,224,ISMILEMEV,Independent,119,0,119,0.06
972,224,MURLIDHAR,Independent,123,1,124,0.06
973,224,YASHPAL,Independent,276,3,279,0.13
974,224,RAKESH SURYAWANSHI,Independent,265,0,265,0.12
975,224,VIPIN JAIN,Independent,860,4,864,0.41
976,224,NOTA,None of the Above,1509,21,1530,0.72
977,107,DR. ASHOK MARSKOLE,Indian National Congress,95803,1385,97188,43.67
978,107,INDAR SINGH UIKEY,Bahujan Samaj Party,3675,21,3696,1.66
979,107,SAMPATIYA UIKEY,Bharatiya Janata Party,112678,457,113135,50.84
980,107,SHRIMATI KALIYA BAI KOKADIYA,Gana Suraksha Party,1189,2,1191,0.54
981,107,MANSINGH KOKADIYA,Bahujan Mukti Party,313,2,315,0.14
982,107,SHISHU SINDHU BHALAVI,Aazad Samaj Party (Kanshi Ram),460,1,461,0.21
983,107,URMILA SINGH UIKEY,Independent,862,7,869,0.39
984,107,KAMLESH UIKEY,Independent,400,3,403,0.18
985,107,DEENDAYAL KUMRE,Independent,502,4,506,0.23
986,107,SUNHER KUSHRAM,Independent,736,1,737,0.33
987,107,SURENDRA SINGH SIRSHYAM,Independent,1136,6,1142,0.51
988,107,NOTA,None of the Above,2865,27,2892,1.3
989,175,UTTAM RAJNARAYAN SINGH PURNI,Indian National Congress,79730,561,80291,47.59
990,175,NARAYAN PATEL,Bharatiya Janata Party,80504,376,80880,47.94
991,175,SHANKAR SINGH S/O DARIYAV SINGH GURJAR (SHANKAR BHAI GURJAR),Bahujan Samaj Party,989,6,995,0.59
992,175,GOPICHAND PATEL (PANWAR) BANJARA,Indian Peoples Adhikar Party,205,0,205,0.12
993,175,DIAMOND KHAN,Aam Bhartiya Party,284,1,285,0.17
994,175,KAILASH PATEL-BANJARA,Independent,117,0,117,0.07
995,175,PRADIP KUMAR THAKUR,Independent,157,1,158,0.09
996,175,PROFESSOR(RET.) MANISHANKAR DONGRE,Independent,147,3,150,0.09
997,175,RAJESH PAWAR BANJARA,Independent,132,6,138,0.08
998,175,ADIWASHI RAHUL CHANDEL,Independent,2899,9,2908,1.72
999,175,SHUBHAM SISODIYA,Independent,382,1,383,0.23
1000,175,SANJeeV NAYAK (BANJARA),Independent,658,1,659,0.39
1001,175,NOTA,None of the Above,1551,3,1554,0.92
1002,199,KANNOJ PARMESHWAR (SHiWRAM GOPAL),Bharatiya Janata Party,89145,376,89521,47.5
1003,199,DINESH DAWAR,Bahujan Samaj Party,1077,1,1078,0.57
1004,199,LALSINGH BARMAN,Aam Aadmi Party,2834,13,2847,1.51
1005,199,Dr. Hiralal Alawa,Indian National Congress,89479,750,90229,47.87
1006,199,Lal Singh Solanki urf Lalu Bhai,Bahujan Dravida Party,1766,3,1769,0.94
1007,199,AMICHAND MUWEL,Independent,516,2,518,0.27
1008,199,MUWEL SURENDRA,Independent,708,0,708,0.38
1009,199,NOTA,None of the Above,1810,4,1814,0.96
1010,228,ANIRUDDHA (MADHAV) MAROO,Bharatiya Janata Party,90650,330,90980,53.94
1011,228,Dr. D.R. KARESHIYA,Bahujan Samaj Party,1287,4,1291,0.77
1012,228,NARENDRA NAHATA,Indian National Congress,71185,808,71993,42.68
1013,228,JAKIR HUSSAIN,Social Democratic Party Of India,1176,1,1177,0.7
1014,228,AZAD MAHESH MEGHWAL,Aazad Samaj Party (Kanshi Ram),915,0,915,0.54
1015,228,RAMESH GURJAR,Independent,476,0,476,0.28
1016,228,NOTA,None of the Above,1840,9,1849,1.1
1017,225,JAGDISH DEVDA,Bharatiya Janata Party,114969,529,115498,54.2
1018,225,NARENDRA MALVIYA,Bahujan Samaj Party,1206,3,1209,0.57
1019,225,PARSHURAM SISODIYA,Indian National Congress,35715,448,36163,16.97
1020,225,BASANTILAL MALVIYA,Independent,1195,6,1201,0.56
1021,225,SHYAMLAL JOKCHAND,Independent,56034,440,56474,26.5
1022,225,LALCHAND MEGHWAL,Independent,819,0,819,0.38
1023,225,NOTA,None of the Above,1720,10,1730,0.81
1024,53,CHANDA,Aam Aadmi Party,1749,2,1751,1.02
1025,53,KUNWAR PRADYUMNA SINGH LODHI,Bharatiya Janata Party,67401,120,67521,39.46
1026,53,BAHIN RAMSIYA BHARTI,Indian National Congress,88613,440,89053,52.04
1027,53,LAKHAN RAMTORIYA,Bahujan Samaj Party,1856,4,1860,1.09
1028,53,ANUJ DINESH YADAV,Vindhya Janta Party,322,0,322,0.19
1029,53,DEVENDRA LODHI,Bhartiya Shakti Chetna Party,393,1,394,0.23
1030,53,ARJUN SINGH CHANDEL,Independent,262,0,262,0.15
1031,53,ASHUTOSH PATHAK,Independent,294,1,295,0.17
1032,53,KARAN SINGH LODHI SUNWAHA,Independent,4210,10,4220,2.47
1033,53,DHARMENDRA KUMAR SAHU,Independent,399,2,401,0.23
1034,53,NARAYAN AHIRWAR,Independent,365,0,365,0.21
1035,53,PANCHU AHIRWAR,Independent,433,0,433,0.25
1036,53,BALKISHAN KACHHI,Independent,1080,0,1080,0.63
1037,53,SARMANA KUSHWAHA,Independent,1182,0,1182,0.69
1038,53,HARI SINGH GOUND,Independent,858,0,858,0.5
1039,53,NOTA,None of the Above,1118,0,1118,0.65
1040,65,DHARMESH GHAI (ROMI),Indian National Congress,54940,536,55476,28.13
1041,65,BIRENDRA PRASAD KUSHWAHA,Bahujan Samaj Party,30618,114,30732,15.59
1042,65,BAIJNATH KUSHWAHA,Aam Aadmi Party,993,4,997,0.51
1043,65,SHRIKANT CHATURVEDI,Bharatiya Janata Party,76525,345,76870,38.98
1044,65,Gore Lal Kole,All India Forward Bloc,925,0,925,0.47
1045,65,CHANDRAPRAKASH PATEL URF CHHOTU BHAIYA,Samajwadi Party,1097,4,1101,0.56
1046,65,NARAYAN TRIPATHI,Vindhya Janta Party,22510,182,22692,11.51
1047,65,RAJNISH KUMAR SHUKLA,Bharatiya Jan Morcha Party,489,0,489,0.25
1048,65,SUSHEEL (PRADEEP) PAL,Kranti Janshakti Party,547,1,548,0.28
1049,65,SANGEETA PURUSHOTTAM KUSHWAHA,Peoples Party of India (Democratic),361,1,362,0.18
1050,65,Umes Kumar Dahiya,Independent,307,1,308,0.16
1051,65,OMPRAKASH (OP Bhaiya),Independent,485,0,485,0.25
1052,65,Gulam Aaka Khan,Independent,966,0,966,0.49
1053,65,NARAYAN TIWARI,Independent,484,1,485,0.25
1054,65,NASIR KHAN,Independent,731,0,731,0.37
1055,65,BHAGAT SINGH LODHI,Independent,2064,1,2065,1.05
1056,65,SAMPAT RAWAT,Independent,1057,0,1057,0.54
1057,65,NOTA,None of the Above,887,3,890,0.45
1058,213,DINESH JAIN BOSS,Indian National Congress,75086,368,75454,42.57
1059,213,BAHADUR SINGH CHOUHAN,Bharatiya Janata Party,74981,183,75164,42.41
1060,213,Radhey shayam,Bahujan Samaj Party,928,3,931,0.53
1061,213,RAJESH - VARSHI,Aazad Samaj Party (Kanshi Ram),1388,0,1388,0.78
1062,213,JUBER KHAN,Independent,179,0,179,0.1
1063,213,Tawar Singh,Independent,233,1,234,0.13
1064,213,DURGESH,Independent,401,0,401,0.23
1065,213,PRATAP SINGH ARYA,Independent,20612,50,20662,11.66
1066,213,BAHADUR SINGH,Independent,818,0,818,0.46
1067,213,SONU VISHWAKARMA,Independent,584,0,584,0.33
1068,213,NOTA,None of the Above,1416,1,1417,0.8
1069,183,RAJKUMAR MEV,Bharatiya Janata Party,94050,333,94383,50.25
1070,183,DR. VIJAYLAXMI SADHO,Indian National Congress,87746,718,88464,47.1
1071,183,SUKHRAM UPADHYAY,Bahujan Samaj Party,1124,6,1130,0.6
1072,183,NARENDRA DHANNALAL VASURE,Independent,838,1,839,0.45
1073,183,RAVI KHEDE,Independent,184,0,184,0.1
1074,183,SHANKAR BILLORE,Independent,305,0,305,0.16
1075,183,DR. M.R. SOLANKI,Independent,863,4,867,0.46
1076,183,NOTA,None of the Above,1656,11,1667,0.89
1077,48,KAMAKHYA PRATAP SINGH (TEEKA RAJA),Bharatiya Janata Party,76631,338,76969,44.84
1078,48,Er. K. R. PATEL RAMJI BHAIYA,Aam Aadmi Party,6457,12,6469,3.77
1079,48,DIXIT NEERAJ VINOD,Indian National Congress,49604,748,50352,29.33
1080,48,Er. MAHESH CHAND KUSHWAHA,Bahujan Samaj Party,19732,80,19812,11.54
1081,48,AJAY DAULAT TIWARI,Samajwadi Party,11764,64,11828,6.89
1082,48,GIRJA PRASAD KUSHWAHA,Jan Adhikar Party,291,1,292,0.17
1083,48,PARASRAM PAL (GADARIYA),Aazad Samaj Party (Kanshi Ram),1421,1,1422,0.83
1084,48,RAKESH PRAJAPATI,Bhagidari Party(P),235,4,239,0.14
1085,48,NIRPAT KUSHWAHA,Independent,237,0,237,0.14
1086,48,PUROSHTTAM NAYAK PUJARI,Independent,249,0,249,0.15
1087,48,AGRAWAL PUSHPENDAR,Independent,389,0,389,0.23
1088,48,RAMPAL AHIRWAR,Independent,1034,1,1035,0.6
1089,48,SACHIN CHAURASIA (SEA WORLD),Independent,681,0,681,0.4
1090,48,NOTA,None of the Above,1675,4,1679,0.98
1091,109,ASHOK MARATHE,Bahujan Samaj Party,3520,36,3556,1.68
1092,109,RAJKUMAR KARRAHE,Bharatiya Janata Party,100505,500,101005,47.61
1093,109,HINA LIKHIRAM KAWRE,Indian National Congress,96954,1278,98232,46.3
1094,109,BASANT KUMAR BOPCHE,"Proutist Bloc, India",1218,0,1218,0.57
1095,109,MOTILAL/BISRAM BISEN,Bhartiya Shakti Chetna Party,507,2,509,0.24
1096,109,OMPRAKASH URF OM YEDE,Independent,581,6,587,0.28
1097,109,CHUNNELAL HARDHE,Independent,1447,1,1448,0.68
1098,109,JYOTI ISHWAR UMRE,Independent,1704,17,1721,0.81
1099,109,TARACHAND KACHLAHE,Independent,996,4,1000,0.47
1100,109,SUNIL SHARMA (MAHARAJ),Independent,1097,4,1101,0.52
1101,109,NOTA,None of the Above,1753,14,1767,0.83
1102,117,YOGENDRA SINGH BABA,Indian National Congress,113513,1006,114519,45.76
1103,117,VIJAY UIKEY,Bharatiya Janata Party,95628,270,95898,38.32
1104,117,GOVIND SINGH,Rashtriya Gondvana Party,1590,6,1596,0.64
1105,117,ADVOCATE RAMKUMAR INWATI,Smart Indians Party,567,1,568,0.23
1106,117,BHAI SANTAR WALARI,Gondvana Gantantra Party,26651,41,26692,10.67
1107,117,AYODHYA PRASAD KUMRE,Independent,570,1,571,0.23
1108,117,JAGMOHAN UIKEY,Independent,359,0,359,0.14
1109,117,NAME SINGH PARTE,Independent,493,4,497,0.2
1110,117,PATI LAL MARSKOLE,Independent,811,2,813,0.32
1111,117,PAWAN MOOLCHAND DHURVE,Independent,714,2,716,0.29
1112,117,SUKHAI LAL UIKEY,Independent,1271,0,1271,0.51
1113,117,ENGINEER SANTOSH UIKEY,Independent,2583,1,2584,1.03
1114,117,NOTA,None of the Above,4184,8,4192,1.67
1115,11,"AMBRISH SHARMA ""GUDDU""",Bharatiya Janata Party,74930,417,75347,42.87
1116,11,Dr. GOVIND SINGH,Indian National Congress,62024,926,62950,35.82
1117,11,RASAL SINGH,Bahujan Samaj Party,31194,154,31348,17.84
1118,11,DHARMENDRA SINGH,Jan Adhikar Party,750,3,753,0.43
1119,11,AMRISH,Independent,137,0,137,0.08
1120,11,AVILAKH SINGH KUSHWAH,Independent,140,3,143,0.08
1121,11,ONKAR SINGH,Independent,114,0,114,0.06
1122,11,CHANDRASHEKHAR DWIVEDI (CHANDU AKHDEVA),Independent,116,0,116,0.07
1123,11,JAYENDRA SINGH,Independent,198,1,199,0.11
1124,11,NAGENDRA SINGH RAJAWAT,Independent,170,0,170,0.1
1125,11,PAVAN KUMAR,Independent,120,0,120,0.07
1126,11,RAVIKANT DADDU,Independent,197,0,197,0.11
1127,11,RAMKUMAR SINGH,Independent,700,0,700,0.4
1128,11,VINOD KUMAR(PAPPU CHACHA),Independent,483,2,485,0.28
1129,11,"SANJEEV ""AAZAD""",Independent,1412,0,1412,0.8
1130,11,NOTA,None of the Above,1554,2,1556,0.89
1131,146,JANKI PRASAD AHIRWAR,Bahujan Samaj Party,2448,5,2453,1.33
1132,146,RANI AHIRWAR,Indian National Congress,75775,499,76274,41.5
1133,146,HARI SINGH SAPRE,Bharatiya Janata Party,101999,344,102343,55.69
1134,146,RAJ KUMAR THEKEDAR,Independent,1234,1,1235,0.67
1135,146,NOTA,None of the Above,1462,7,1469,0.8
1136,198,AJAY RAWAT,Bahujan Samaj Party,2092,6,2098,1.12
1137,198,Baghel Surendra Singh Honey,Indian National Congress,112756,1708,114464,61.32
1138,198,BHINDE JAYDEEP PATEL,Bharatiya Janata Party,64149,427,64576,34.59
1139,198,BONDARSINGH MUJHALDA,Independent,1456,4,1460,0.78
1140,198,MAGANSINGH BAGHEL,Independent,1112,3,1115,0.6
1141,198,SHIVAJI PATEL KALMI,Independent,1079,3,1082,0.58
1142,198,NOTA,None of the Above,1883,2,1885,1.01
1143,86,DILIP JAISWAL,Bharatiya Janata Party,65534,284,65818,55.48
1144,86,SUNEEL SARAF,Indian National Congress,42459,571,43030,36.27
1145,86,KALI CHARAN CHOUDHARY,Bahujan Gondwana Party,783,3,786,0.66
1146,86,GIRISH KUMAR TIWARI,Bhartiya Shakti Chetna Party,221,4,225,0.19
1147,86,NIRMALA PRAJAPATI,Peoples Party of India (Democratic),156,1,157,0.13
1148,86,MADRU CHOUDHRY,Vastavik Bharat Party,249,0,249,0.21
1149,86,VINOD KRISHNA PAL SINGH,Samajwadi Party,320,2,322,0.27
1150,86,SEEMA KEWAT,Gondvana Gantantra Party,2966,11,2977,2.51
1151,86,ABDUL ALI,Independent,217,2,219,0.18
1152,86,ABHAYANAND BABA JE,Independent,404,2,406,0.34
1153,86,DINESH LAHRE,Independent,540,3,543,0.46
1154,86,MD. ANWAR,Independent,298,1,299,0.25
1155,86,RAM PAL SAHU,Independent,459,3,462,0.39
1156,86,SAHAS RAM KEWAT,Independent,1067,1,1068,0.9
1157,86,HEERAVATI MAHRA,Independent,580,3,583,0.49
1158,86,NOTA,None of the Above,1481,5,1486,1.25
1159,27,NAVAL DHAKAD,Bahujan Samaj Party,24867,19,24886,12.44
1160,27,BAIJNATH SINGH YADAV DADA JI,Indian National Congress,57579,133,57712,28.85
1161,27,MAHENDRA RAMSINGH YADAV KHATORA,Bharatiya Janata Party,108559,126,108685,54.32
1162,27,THAKURLAL JATAV,Aazad Samaj Party (Kanshi Ram),1682,1,1683,0.84
1163,27,SURESH LODHI,Pichhara Samaj Party United,274,0,274,0.14
1164,27,ANiL KUMAR LODHi,Independent,277,0,277,0.14
1165,27,ENDRAPAL SINGH KUSHWAH,Independent,856,1,857,0.43
1166,27,NAVAL SINGH DHAKAD,Independent,199,0,199,0.1
1167,27,PRAHLAD - ADIWASI,Independent,534,0,534,0.27
1168,27,MAHENDRA SiNGH Yadav,Independent,1417,0,1417,0.71
1169,27,VIRSINGH JATAV,Independent,977,0,977,0.49
1170,27,HARVEER SINGH YADAV,Independent,763,0,763,0.38
1171,27,NOTA,None of the Above,1804,1,1805,0.9
1172,36,BHOOPENDRA SINGH,Bharatiya Janata Party,105879,557,106436,62.21
1173,36,MANOJ KUMAR RAJAK,Bahujan Samaj Party,1947,5,1952,1.14
1174,36,BAHEN RAKSHA SINGH RAJPUT,Indian National Congress,58831,280,59111,34.55
1175,36,CHALI RAJA LODHI,Bhartiya Shakti Chetna Party,1334,4,1338,0.78
1176,36,AZIZ KHAN,Independent,163,1,164,0.1
1177,36,"BHUPENDRA LODHI ""BHUPENDRA BHAIYA""",Independent,148,1,149,0.09
1178,36,MANOJ KUMAR JAIN PUJARI,Independent,288,0,288,0.17
1179,36,LAKKHU AHIRWAR,Independent,335,0,335,0.2
1180,36,NOTA,None of the Above,1324,1,1325,0.77
1181,163,DINESHCHANDRA JHARNYA,Bahujan Samaj Party,1727,6,1733,0.86
1182,163,PRIYAVRAT SINGH,Indian National Congress,90522,1494,92016,45.44
1183,163,HAJARILAL DANGI,Bharatiya Janata Party,104348,1346,105694,52.2
1184,163,RADHESHYAM,Bhartiya Shakti Chetna Party,1372,8,1380,0.68
1185,163,KAILASH - DHANNALAL VERMA,Independent,548,4,552,0.27
1186,163,NOTA,None of the Above,1103,11,1114,0.55
1187,173,AASHISH GOVIND SHARMA,Bharatiya Janata Party,98014,615,98629,51.35
1188,173,DEEPAK KELASH JOSHI,Indian National Congress,85463,624,86087,44.82
1189,173,ANIL S/O RAMBHROSH VISHVKARMA (SUTAR),Aam Bhartiya Party,1157,1,1158,0.6
1190,173,GOKUL PRASAD HARIYALE,Aazad Samaj Party (Kanshi Ram),1989,10,1999,1.04
1191,173,AASHARAM (ASHU) BHAVSAR,Independent,883,6,889,0.46
1192,173,OMPRAKASH SARATIYA,Independent,219,2,221,0.12
1193,173,NARMDA PRASAD SARATHE BABUJI,Independent,192,0,192,0.1
1194,173,KU. MAHENDRA SHINGH CHOUHAN,Independent,386,2,388,0.2
1195,173,MUBARIK KHA PITA MOHAMMAD SAFI,Independent,871,1,872,0.45
1196,173,NOTA,None of the Above,1636,6,1642,0.85
1197,185,AJAY BHALSE,Bahujan Samaj Party,1552,15,1567,0.8
1198,185,BALKRISHN PATIDAR,Bharatiya Janata Party,100518,1165,101683,51.63
1199,185,RAVI JOSHI,Indian National Congress,86412,1506,87918,44.64
1200,185,SANJAY GANGLE,Republican Party of India (A),766,3,769,0.39
1201,185,AFGHAN KHAN,Independent,200,1,201,0.1
1202,185,NAJMUDDIN SHEIKH,Independent,167,0,167,0.08
1203,185,PANKAJ NAYAK,Independent,191,2,193,0.1
1204,185,SHABANAM ADIB BAWA,Independent,794,1,795,0.4
1205,185,SATNAM MANJEET SINGH BHATIYA ALIAS RAJ,Independent,841,0,841,0.43
1206,185,SANTOSH SHIVRAM PATIDAR,Independent,708,1,709,0.36
1207,185,SUNIL VERMA,Independent,678,0,678,0.34
1208,185,NOTA,None of the Above,1396,13,1409,0.72
1209,47,CHANDA-SURENDRA SINGH GOUR,Indian National Congress,83137,602,83739,44.32
1210,47,PYARE LAL SONI,Aam Aadmi Party,12152,22,12174,6.44
1211,47,RAHUL SINGH LODHI,Bharatiya Janata Party,75440,182,75622,40.03
1212,47,SHIKHA HRADESH KUSHWAHA,Bahujan Samaj Party,8533,26,8559,4.53
1213,47,AHIRWAR RADHELAL,Aazad Samaj Party (Kanshi Ram),543,6,549,0.29
1214,47,LAKHAN LAL LODHI,Bharatiya Sabhyata Party,319,0,319,0.17
1215,47,SHOBHARAM RAIKWAR,Loktanter Suraksha Party,882,0,882,0.47
1216,47,AJAY SINGH YADAV,Independent,1450,8,1458,0.77
1217,47,CHANDRABHAN,Independent,295,3,298,0.16
1218,47,PRASHANT SHUKLA,Independent,419,0,419,0.22
1219,47,VALVANT BALMEEK,Independent,371,1,372,0.2
1220,47,MOHAN LAL,Independent,532,0,532,0.28
1221,47,MANJU SINGH LODHI,Independent,1015,1,1016,0.54
1222,47,SUNIL SINGH,Independent,757,0,757,0.4
1223,47,NOTA,None of the Above,2236,0,2236,1.18
1224,177,KUNDAN MALVIYA,Indian National Congress,69992,1026,71018,38.54
1225,177,KANCHAN MUKESH TANVE,Bharatiya Janata Party,107922,1145,109067,59.19
1226,177,SANDEEP ATOOT,Bahujan Samaj Party,1096,11,1107,0.6
1227,177,NARENDRA NAGRE,Aazad Samaj Party (Kanshi Ram),494,2,496,0.27
1228,177,LAXMINARAYAN KATARE,All India Forward Bloc,231,5,236,0.13
1229,177,PRAKASH TARACHAND EKLE,Independent,469,6,475,0.26
1230,177,NOTA,None of the Above,1846,30,1876,1.02
1231,116,RAJNEESH HARVANSH SINGH,Indian National Congress,121666,1148,122814,53.2
1232,116,RAKESH PAL SINGH,Bharatiya Janata Party,88713,341,89054,38.58
1233,116,JAYKUMAR,Gana Suraksha Party,744,1,745,0.32
1234,116,DR.SATISH NAG(DOCTOR SAHAB),Mahakaushal Rashtriya Party,272,2,274,0.12
1235,116,AANAND BAGHEL,Independent,341,5,346,0.15
1236,116,KALEEMUDDEEN (MOULANA),Independent,148,1,149,0.06
1237,116,GAJENDRASING,Independent,329,1,330,0.14
1238,116,TEKCHAND BARMAIYA,Independent,244,2,246,0.11
1239,116,PREETAM UIKEY,Independent,11618,21,11639,5.04
1240,116,BHEEM LODHI,Independent,764,0,764,0.33
1241,116,Dr. SUNIL RAI,Independent,827,1,828,0.36
1242,116,SANJAY KUMAR MISHRA,Independent,1176,1,1177,0.51
1243,116,NOTA,None of the Above,2482,10,2492,1.08
1244,113,UDAYSINGH PANCHESHWAR GURUJI,Bahujan Samaj Party,4700,43,4743,2.68
1245,113,GAURAV SINGH PARDHI,Bharatiya Janata Party,85599,351,85950,48.51
1246,113,ENGG. PRASHANT BHAU,Aam Aadmi Party,10955,74,11029,6.22
1247,113,BODHSINGH BHAGAT,Indian National Congress,63043,976,64019,36.13
1248,113,MAHESH SAHARE,Samajwadi Party,563,1,564,0.32
1249,113,SADASIV HARINKHEDE,Bahujan Mukti Party,407,4,411,0.23
1250,113,KESHAR BISEN (BAHANJEE),Independent,7121,46,7167,4.04
1251,113,BHARAT MULAKRAJ ANAND,Independent,444,2,446,0.25
1252,113,BHOUNENDRA MISHRILAL DAHARWAL,Independent,1026,10,1036,0.58
1253,113,MULAKRAJ ANAND,Independent,793,0,793,0.45
1254,113,NOTA,None of the Above,1025,2,1027,0.58
1255,184,ATMARAM PATEL,Bharatiya Janata Party,96912,177,97089,47.4
1256,184,NARENDRA KANCHOLE,Bahujan Samaj Party,1476,4,1480,0.72
1257,184,SACHIN SUBHASHCHANDRA YADAV,Indian National Congress,102284,477,102761,50.17
1258,184,SUNIL CHOUHAN,Aazad Samaj Party (Kanshi Ram),1826,2,1828,0.89
1259,184,NOTA,None of the Above,1652,4,1656,0.81
1260,23,PRAGILAL JATAV,Indian National Congress,95479,722,96201,47.58
1261,23,KHATIK RAMESH PRASAD,Bharatiya Janata Party,98929,375,99304,49.11
1262,23,SHANTI DAS FALE (JATAV),Bahujan Samaj Party,1718,11,1729,0.86
1263,23,JADISH KALAWAT,Jan Adhikar Party,338,1,339,0.17
1264,23,JATAV NATHURAM,Samatamoolak Samaj Party,194,1,195,0.1
1265,23,KOLI MEENA,Rashtriya Samaj Paksha,686,3,689,0.34
1266,23,MUKESH KUMAR SHASAK,Bahujan Mukti Party,256,0,256,0.13
1267,23,RAMESHWAR AZAD,Aazad Samaj Party (Kanshi Ram),616,6,622,0.31
1268,23,GULAB SINGH AHIRWAR,Independent,388,0,388,0.19
1269,23,RAKESH JONWAR,Independent,790,2,792,0.39
1270,23,NOTA,None of the Above,1676,7,1683,0.83
1271,169,KUNAL CHOUDHARY,Indian National Congress,85780,671,86451,44.37
1272,169,GHANSHYAM CHANDRAVANSHI,Bharatiya Janata Party,97721,495,98216,50.41
1273,169,JIVAN SINGH MALVIYA,Bahujan Samaj Party,889,5,894,0.46
1274,169,AJABSINGH MEENA (PATRAKAR),Jai Lok Party,298,0,298,0.15
1275,169,YOGESH MALVIYA,Aazad Samaj Party (Kanshi Ram),3146,7,3153,1.62
1276,169,CHATURBHUJ TOMAR ADVOCATE,Independent,4041,46,4087,2.1
1277,169,CHANDRASHEKHAR BARODH (CHHAPRI),Independent,783,4,787,0.4
1278,169,NOTA,None of the Above,934,5,939,0.48
1279,122,NATHANSHAH KAWRETI,Bharatiya Janata Party,79611,556,80167,42.03
1280,122,SUNIL UIKEY,Indian National Congress,82496,881,83377,43.72
1281,122,PRAKASH KUMRE,Rashtriya Gondvana Party,2757,10,2767,1.45
1282,122,HARIRAM SALLAM,Gondvana Gantantra Party,4944,34,4978,2.61
1283,122,JHAMAKLAL SARYAM,Independent,8539,31,8570,4.49
1284,122,DEVIPRASAD UIKEY,Independent,1013,11,1024,0.54
1285,122,SUNIL UIKEY,Independent,627,8,635,0.33
1286,122,SUNIL UIKEY,Independent,827,12,839,0.44
1287,122,SUNIL UIKEY,Independent,782,2,784,0.41
1288,122,SUMARSING DARSMA (MAWASI),Independent,2485,5,2490,1.31
1289,122,NOTA,None of the Above,5072,14,5086,2.67
1290,192,VISHAL RAWAT,Bharatiya Janata Party,41608,419,42027,25.34
1291,192,SENA - MAHESH PATEL,Indian National Congress,79640,1144,80784,48.71
1292,192,MoHANSINGH NINGWAL,Bhartiya Samajik Party,3205,11,3216,1.94
1293,192,AJNAR SURPAL SINGH,Independent,9522,92,9614,5.8
1294,192,DAWAR RINKU BALA,Independent,2472,55,2527,1.52
1295,192,DILEEP SINGH BHURIYA,Independent,1724,13,1737,1.05
1296,192,MADHOSINGH DAWAR,Independent,21078,234,21312,12.85
1297,192,NOTA,None of the Above,4630,13,4643,2.8
1298,193,BALU,Bahujan Samaj Party,3634,2,3636,1.76
1299,193,BHANU BHURIYA,Bharatiya Janata Party,86716,742,87458,42.29
1300,193,DR. VIKRANT BHURIA,Indian National Congress,102010,1141,103151,49.87
1301,193,GABBAR SINGH,Bharat Adivasi Party,2933,5,2938,1.42
1302,193,AMRA BHABOR,Independent,1392,2,1394,0.67
1303,193,AMARU MOHANIYA,Independent,883,1,884,0.43
1304,193,KALAMSINGH BHABOR,Independent,1212,5,1217,0.59
1305,193,DHANSINGH BARIYA,Independent,2530,25,2555,1.24
1306,193,NOTA,None of the Above,3589,7,3596,1.74
1307,230,OMPRAKASH SAKHLECHA,Bharatiya Janata Party,60216,242,60458,38
1308,230,LILARAM MALVIYA,Bahujan Samaj Party,717,3,720,0.45
1309,230,SAMANDAR PATEL,Indian National Congress,57541,553,58094,36.51
1310,230,RETiRED FOJI-OMPRAKASH KANDARA,Aazad Samaj Party (Kanshi Ram),964,2,966,0.61
1311,230,SAVITRI MEGHWAL,United National Party,286,0,286,0.18
1312,230,AHIR PURANMAL,Independent,36085,66,36151,22.72
1313,230,OM PRAKASH,Independent,724,0,724,0.46
1314,230,MO BHURA KURESHI,Independent,397,0,397,0.25
1315,230,NOTA,None of the Above,1313,2,1315,0.83
1316,4,PANKAJ UPADHYAY,Indian National Congress,88109,1144,89253,46.71
1317,4,FOUJI BHAGWATI DHAKAD RAJODHA,Aam Aadmi Party,1950,16,1966,1.03
1318,4,SUBEDAR SINGH SIKARWAR RAJOUDHA,Bharatiya Janata Party,58625,347,58972,30.86
1319,4,SONERAM KUSHWAH,Bahujan Samaj Party,36893,145,37038,19.38
1320,4,ANIL DHAKAD ASALPUR,Parivartan Party of India,248,0,248,0.13
1321,4,Arjun Singh Sikarwar (Ranchhorpura),Bharatiya Majdoor Janta Party,143,3,146,0.08
1322,4,PATIRAM BAGHORAKHURD,Jan Adhikar Party,94,0,94,0.05
1323,4,BHARAT LAL UMARAIYA,Aazad Samaj Party (Kanshi Ram),463,0,463,0.24
1324,4,MANIRAM DHAKAD,Samajwadi Party,905,8,913,0.48
1325,4,REENA KUSHWAH,All India Forward Bloc,235,1,236,0.12
1326,4,SATTAR SYA,Public Political Party,100,0,100,0.05
1327,4,ALOK SHARMA,Independent,123,0,123,0.06
1328,4,ANKUSH UPADHYAY,Independent,220,0,220,0.12
1329,4,JITENDRA SINGH DHAKAD,Independent,276,1,277,0.14
1330,4,RAMKUMAR JATAV (SOLANKI),Independent,178,0,178,0.09
1331,4,NOTA,None of the Above,847,6,853,0.45
1332,44,ANITAPRABHUDAYAL KHATIK,Aam Aadmi Party,1147,7,1154,0.69
1333,44,AHIRWAR KIRAN,Indian National Congress,64147,580,64727,38.95
1334,44,AHIRWAR DHARMENDRA,Bahujan Samaj Party,1876,2,1878,1.13
1335,44,KHATIK HARISHANKAR,Bharatiya Janata Party,75678,265,75943,45.7
1336,44,AHIRWAR SAVITHRI,Bharastachar Apraadh Mukt Nyay Dal,1160,1,1161,0.7
1337,44,PREM NARAYAN AHIRWAR,Aazad Samaj Party (Kanshi Ram),306,3,309,0.19
1338,44,ADVOCATE MUKESH AHIRWAR,Jan Adhikar Party,258,1,259,0.16
1339,44,R. R. BANSAL,Samajwadi Party,15034,26,15060,9.06
1340,44,RAJESH BANSKAR,Akhil Bhartiya Aarakshit Samaj Party,263,0,263,0.16
1341,44,AMIT KUMAR SUTRAKAR,Independent,172,2,174,0.1
1342,44,AHIRWAR DAMODAR,Independent,330,0,330,0.2
1343,44,AHIRWAR MAHENDRA,Independent,264,0,264,0.16
1344,44,KASHI RAM BANSHKAR,Independent,465,0,465,0.28
1345,44,KOMAL CHANDRA AHIRWAR,Independent,963,0,963,0.58
1346,44,KHATIK PRAMOD,Independent,826,0,826,0.5
1347,44,RAMESH KUMAR PRAJAPATI,Independent,979,1,980,0.59
1348,44,Rajendra Ahirwar,Independent,336,0,336,0.2
1349,44,NOTA,None of the Above,1076,1,1077,0.65
1350,222,DASHRATH SAI AANJANA,Bahujan Samaj Party,1042,4,1046,0.51
1351,222,"RAJENDRA PANDEY ""RAJU BHAIYA""",Bharatiya Janata Party,91343,676,92019,44.89
1352,222,VIRENDRA SINGH SOLANKI,Indian National Congress,65003,995,65998,32.19
1353,222,DILAVAR KHAN,Aazad Samaj Party (Kanshi Ram),2143,11,2154,1.05
1354,222,ENGINEER VIJAY SINGH YADAV ( ADVOCATE ),Bhartiya Swarnim Yug Party,687,1,688,0.34
1355,222,JEEVAN SINGH SHERPUR,Independent,40518,248,40766,19.89
1356,222,MOHAN PARIHAR,Independent,817,5,822,0.4
1357,222,RAMESHWAR DABI,Independent,411,2,413,0.2
1358,222,NOTA,None of the Above,1084,16,1100,0.54
1359,85,UMA DHURVEY,Indian National Congress,75137,856,75993,37.86
1360,85,JAISINGH MARAVI,Bharatiya Janata Party,107319,379,107698,53.66
1361,85,KATAHURA,Aazad Samaj Party (Kanshi Ram),2097,1,2098,1.05
1362,85,KAJAL BAI,Vastavik Bharat Party,666,1,667,0.33
1363,85,NARAYAN SINGH KUSHRAM,Bahujan Gondwana Party,650,3,653,0.33
1364,85,PAW BHEEMSEN SINGH,Peoples Party of India (Democratic),1242,7,1249,0.62
1365,85,PHATEBAHADUR,Bhartiya Shakti Chetna Party,549,2,551,0.27
1366,85,BHARAT SINGH OLADI,Gondvana Gantantra Party,5078,12,5090,2.54
1367,85,VIKRAM BAIGA,Vindhya Janta Party,666,2,668,0.33
1368,85,VISHESHAR SINGH PAW,Samajwadi Party,993,0,993,0.49
1369,85,SHIVPRASAD SINGH PAVLE,Independent,1429,2,1431,0.71
1370,85,NOTA,None of the Above,3619,7,3626,1.81
1371,84,NARENDRA SINGH MARAVI,Indian National Congress,75667,1349,77016,36.76
1372,84,MANISHA SINGH,Bharatiya Janata Party,114442,525,114967,54.87
1373,84,RANJEET SINGH (PINTU),Bahujan Samaj Party,5515,31,5546,2.65
1374,84,ENGINEER KAUSHALESH KUMAR BAIGA,Samajwadi Party,1190,10,1200,0.57
1375,84,PHOOLBATI SINGH,Vindhya Janta Party,784,9,793,0.38
1376,84,Baiga Bisahu Lal,Peoples Party of India (Democratic),560,4,564,0.27
1377,84,MANOJ KUMAR PANIKA,Indian Peoples Adhikar Party,529,3,532,0.25
1378,84,AJAY KOL (KOLA),Independent,473,0,473,0.23
1379,84,KAMTA SINGH MASRAM,Independent,731,3,734,0.35
1380,84,KOL RAMESH,Independent,1305,5,1310,0.63
1381,84,SHIV KUMAR BAIGA,Independent,2474,4,2478,1.18
1382,84,NOTA,None of the Above,3887,22,3909,1.87
1383,56,DHARMENDRA BHAV SINGH LODHI,Bharatiya Janata Party,72048,201,72249,37.21
1384,56,PRATAP SINGH,Indian National Congress,55726,640,56366,29.03
1385,56,VINOD RAI,Gondvana Gantantra Party,52438,219,52657,27.12
1386,56,DR. SUJAN SINGH THAKUR,Bhartiya Shakti Chetna Party,6080,28,6108,3.15
1387,56,DHARMENDRA SINGH,Independent,475,3,478,0.25
1388,56,PRATAP SINGH LODHI,Independent,214,0,214,0.11
1389,56,PRATAP BHAIYA,Independent,233,2,235,0.12
1390,56,BASANT RAI,Independent,545,1,546,0.28
1391,56,BHAGWAN DAS PRAJAPATI,Independent,442,1,443,0.23
1392,56,RAGHVENDRA SINGH,Independent,619,3,622,0.32
1393,56,VINOD BHAIYA,Independent,1456,1,1457,0.75
1394,56,VINOD JEE BHAISAB,Independent,756,0,756,0.39
1395,56,NOTA,None of the Above,2014,9,2023,1.04
1396,98,ABHILASH PANDEY,Bharatiya Janata Party,87745,674,88419,56.09
1397,98,VINAY SAXENA,Indian National Congress,64959,805,65764,41.72
1398,98,SIKANDAR ALI,Bahujan Samaj Party,1047,4,1051,0.67
1399,98,DEVENDRA SHUKLA,Bharatiya Sampuran Krantikari Party,193,0,193,0.12
1400,98,BALRAM SHRIVASTAVA,Indian Peoples Adhikar Party,105,1,106,0.07
1401,98,BRIJESH PATHAK,Sarvadharam Party (Madhya Pradesh),73,0,73,0.05
1402,98,SANJAY JAIN ''SANJU MAMA'',Janata Dal (United),376,4,380,0.24
1403,98,"RAJNEESH NAVERIA ""PT. RAJNEESH NAVERIA""",Independent,232,1,233,0.15
1404,98,NOTA,None of the Above,1404,14,1418,0.9
1405,97,ANCHAL SONKAR,Bharatiya Janata Party,67477,455,67932,39.3
1406,97,BALKISHAN CHOUDHARY,Bahujan Samaj Party,4260,26,4286,2.48
1407,97,LAKHAN GHANGHORIA,Indian National Congress,94961,712,95673,55.35
1408,97,ARVIND KUMAR BIRAHA,Bahujan Mukti Party,643,1,644,0.37
1409,97,"GAJENDRA SONKER ""GAJJU""",All India Majlis-E-Ittehadul Muslimeen,2579,5,2584,1.49
1410,97,VISHNU MALIK,Independent,303,0,303,0.18
1411,97,NOTA,None of the Above,1422,22,1444,0.84
1412,100,TARUN BHANOT,Indian National Congress,64946,1188,66134,39.72
1413,100,AD. DINESH KUMAR KUSHWAHA,Bahujan Samaj Party,1302,24,1326,0.8
1414,100,RAKESH SINGH,Bharatiya Janata Party,95381,887,96268,57.82
1415,100,GEETA PATHAK,Sarvadharam Party (Madhya Pradesh),399,2,401,0.24
1416,100,SACHIN GUPTA,Indian Peoples Adhikar Party,116,1,117,0.07
1417,100,PIYUSH VERMA,Independent,73,0,73,0.04
1418,100,BRAMHANAND BAIRAGI,Independent,76,0,76,0.05
1419,100,RAMESH DHARVE,Independent,126,2,128,0.08
1420,100,RAM PRAKASH KUSHWAHA,Independent,319,3,322,0.19
1421,100,VISHNU KUMAR JAROLIYA,Independent,213,0,213,0.13
1422,100,NOTA,None of the Above,1434,11,1445,0.87
1423,99,ABHISHEK CHINTU CHOUKSEY,Indian National Congress,46001,920,46921,36.34
1424,99,ASHOK ISHWARDAS ROHANI,Bharatiya Janata Party,76183,783,76966,59.6
1425,99,RAJESH KUMAR VERMA,Aam Aadmi Party,727,17,744,0.58
1426,99,ER. RAJESH KUMAR SINGH,Bahujan Samaj Party,1620,20,1640,1.27
1427,99,ADVOCATE ANIL RAIDAS,Aazad Samaj Party (Kanshi Ram),125,2,127,0.1
1428,99,DEVENDRA KUMAR YADAV,Samajwadi Party,115,3,118,0.09
1429,99,DHARMENDRA KUMAR TIWARI (ADVOCATE),Bhartiya Shakti Chetna Party,83,0,83,0.06
1430,99,ER RAJEEV KUMAR GUPTA,Akhand Bharat Chetna Dal,42,2,44,0.03
1431,99,AJAY KUMAR MISHRA,Independent,116,2,118,0.09
1432,99,ARUN GAIKWAD,Independent,47,2,49,0.04
1433,99,UMESH SINGH,Independent,124,5,129,0.1
1434,99,NITESH KUMAR PANDEY,Independent,115,1,116,0.09
1435,99,RAMKUMAR,Independent,100,3,103,0.08
1436,99,RAMDAYAL MANAV URF (GODH KUMHAR MANAV),Independent,141,1,142,0.11
1437,99,SHASHI STELLA,Independent,497,1,498,0.39
1438,99,NOTA,None of the Above,1315,14,1329,1.03
1439,208,MANOHAR BIJORE,Bahujan Samaj Party,1195,10,1205,0.43
1440,208,MAHENDRA HARDIA,Bharatiya Janata Party,143449,1284,144733,51.43
1441,208,VINOD TYAGI,Aam Aadmi Party,1073,10,1083,0.38
1442,208,SATYANARAYAN RAMESHWAR PATEL,Indian National Congress,128045,1017,129062,45.86
1443,208,Abid HUSSAiN,Aazad Samaj Party (Kanshi Ram),914,2,916,0.33
1444,208,FAISAL WASEEM SHAIKH,All India Majlis-E-Ittehadul Muslimeen,660,0,660,0.23
1445,208,MOHAMMAD JAMEEL,Social Democratic Party Of India,131,0,131,0.05
1446,208,AMIT SOLANKI (HARDIYA),Independent,141,2,143,0.05
1447,208,AYAZ Ali,Independent,92,0,92,0.03
1448,208,GEEYASUDDEEN,Independent,114,2,116,0.04
1449,208,CHANA GNANESH,Independent,155,2,157,0.06
1450,208,JAYESH TAYDE,Independent,72,1,73,0.03
1451,208,POONAM KHANDELWAL,Independent,146,6,152,0.05
1452,208,SALIM PATHAN,Independent,155,2,157,0.06
1453,208,DR. SUBHASH BARODH,Independent,574,3,577,0.21
1454,208,SANJEEV (SANJU BHAiYA),Independent,620,2,622,0.22
1455,208,NOTA,None of the Above,1529,20,1549,0.55
1456,207,DR.PIYUSH JOSHI,Aam Aadmi Party,3340,34,3374,1.93
1457,207,MALINI LAXMANSINGH GAUR,Bharatiya Janata Party,118039,831,118870,68.09
1458,207,P L RAJA MANDHWANI,Indian National Congress,48669,364,49033,28.09
1459,207,SATYA NARAYAN BINDORIYA (B.A.),Bahujan Samaj Party,520,5,525,0.3
1460,207,JAGDISH NEBHANI,Independent,233,5,238,0.14
1461,207,PARMANAND TOLANI,Independent,103,1,104,0.06
1462,207,VIJAY INGLE,Independent,138,3,141,0.08
1463,207,VIJAY DUBEY,Independent,311,1,312,0.18
1464,207,NOTA,None of the Above,1969,17,1986,1.14
1465,206,"Deepak Mahesh Joshi "" Pintu """,Indian National Congress,58219,565,58784,43.65
1466,206,PRAKASH VERMA,Bahujan Samaj Party,395,16,411,0.31
1467,206,GOLU SHUKLA RAKESH,Bharatiya Janata Party,72821,720,73541,54.61
1468,206,BIBHISHAN NAIK,Republican Party of India (A),288,2,290,0.22
1469,206,ANAND JAIN,Independent,102,2,104,0.08
1470,206,ADVOCATE PANKAJ GUPTE VAKiL SAHAB,Independent,72,1,73,0.05
1471,206,MAHESH JOSHI PINTU,Independent,249,5,254,0.19
1472,206,RAJENDRA SINGH PANWAR,Independent,97,1,98,0.07
1473,206,NOTA,None of the Above,1106,11,1117,0.83
1474,205,CHINTU CHOUKSE,Indian National Congress,61376,648,62024,26.26
1475,205,DHARAMDAS AHIRWAR,Bahujan Samaj Party,1406,26,1432,0.61
1476,205,RAMESH MENDOLA,Bharatiya Janata Party,167939,1132,169071,71.58
1477,205,PRAMOD NAMDEV,Socialist Unity Centre Of India (COMMUNIST),666,2,668,0.28
1478,205,BASANT GEHLOT,Jan Sangh Party,197,2,199,0.08
1479,205,BHUPENDRA. TiWARi,Independent,167,1,168,0.07
1480,205,MAHESH KUMAR GARJE(MEHUL),Independent,308,0,308,0.13
1481,205,RAJA CHOUDHARY,Independent,188,0,188,0.08
1482,205,NOTA,None of the Above,2118,24,2142,0.91
1483,204,ANURAG YADAV (DEEPU BHAIYA),Aam Aadmi Party,1391,11,1402,0.53
1484,204,KAILASH VIJAYVARGIYA,Bharatiya Janata Party,156960,1163,158123,59.67
1485,204,Er. SUNEEL KUMAR AHIRWAR,Bahujan Samaj Party,836,15,851,0.32
1486,204,SANJAY SHUKLA,Indian National Congress,99241,943,100184,37.81
1487,204,YASiR. PATHAN,All India Majlis-E-Ittehadul Muslimeen,1518,1,1519,0.57
1488,204,ABHAY JAIN,Independent,395,1,396,0.15
1489,204,ABHINANDAN,Independent,113,3,116,0.04
1490,204,MANISH,Independent,232,5,237,0.09
1491,204,RAKESH SURENDRA KUMAR,Independent,127,0,127,0.05
1492,204,SANJAY SHUKLA,Independent,631,8,639,0.24
1493,204,NOTA,None of the Above,1381,3,1384,0.52
1494,158,KARAN SINGH VERMA,Bharatiya Janata Party,102733,472,103205,52.59
1495,158,SHAILENDRA PATEL,Indian National Congress,86093,766,86859,44.26
1496,158,HARI PRASAD SISODIYA,Bahujan Samaj Party,1281,12,1293,0.66
1497,158,JITENDRA KUMAR,Aazad Samaj Party (Kanshi Ram),1300,3,1303,0.66
1498,158,DHOOL SINGH DHAMMA,Bahujan Mukti Party,116,0,116,0.06
1499,158,AJABSINGH MEWADA,Independent,781,3,784,0.4
1500,158,GURMEET SINGH GANDHI,Independent,117,0,117,0.06
1501,158,JAIN,Independent,105,0,105,0.05
1502,158,DAULAT SINGH,Independent,268,0,268,0.14
1503,158,MOHAN SINGH,Independent,281,0,281,0.14
1504,158,RMESH BARELA,Independent,580,0,580,0.3
1505,158,NOTA,None of the Above,1316,6,1322,0.67
1506,155,NARESH GYANCHANDANI,Indian National Congress,79090,755,79845,30.23
1507,155,RANDHEER BHOJNE,Bahujan Samaj Party,1790,28,1818,0.69
1508,155,DR. RAVI DWIVEDI,Aam Aadmi Party,1359,22,1381,0.52
1509,155,RAMESHWAR SHARMA,Bharatiya Janata Party,176495,1260,177755,67.31
1510,155,YOGESH BAMANIYA,Right to Recall Party,837,3,840,0.32
1511,155,MD. IRSHAD (GUDDU BHAI),Independent,324,2,326,0.12
1512,155,NOTA,None of the Above,2107,28,2135,0.81
1513,137,GIRIJASHANKER SHARMA,Indian National Congress,33029,610,33639,19.71
1514,137,PRADEEP MANJHI,Bahujan Samaj Party,1959,38,1997,1.17
1515,137,DR. SITA SARAN SHARMA,Bharatiya Janata Party,72555,606,73161,42.87
1516,137,ABHISHEK CHOUDHARY,Right to Recall Party,353,3,356,0.21
1517,137,GULAB DAS BADODIYA,Rashtriya Navjagran Party,387,8,395,0.23
1518,137,SATENDRA KUMAR,Akhand Bharat Samrajya Party,112,0,112,0.07
1519,137,SURENDRA LUTARE,National World Leader Party,207,4,211,0.12
1520,137,SURENDRA WADIWA,Bahujan Mukti Party,271,7,278,0.16
1521,137,AJAY SHUKLA,Independent,1019,5,1024,0.6
1522,137,BHAGVATI PRASAD CHOUREY,Independent,57071,584,57655,33.78
1523,137,HARIOM KEER,Independent,385,0,385,0.23
1524,137,NOTA,None of the Above,1416,28,1444,0.85
1525,57,Smt Umadevi Lalchand Khatik,Bharatiya Janata Party,106129,417,106546,58.48
1526,57,PRADEEP KHATIK,Indian National Congress,48766,759,49525,27.18
1527,57,BHAGWAN DAS CHOUDHARY,Bahujan Samaj Party,19188,174,19362,10.63
1528,57,AMOL CHOUDHARY,Samajwadi Party,472,2,474,0.26
1529,57,OMVATI / SANJAY ATHYA,Bhartiya Shakti Chetna Party,1967,16,1983,1.09
1530,57,Akash / Laxmi Kori,Independent,339,1,340,0.19
1531,57,KODULAL AHIRWAL,Independent,319,0,319,0.18
1532,57,Devraj Singh Sooryavanshi (Ahirwar),Independent,644,1,645,0.35
1533,57,Lalchand Kashyap (Kori),Independent,814,0,814,0.45
1534,57,NOTA,None of the Above,2179,8,2187,1.2
1535,172,MANOJ NARAYANSINGH CHOUDHARI,Bharatiya Janata Party,89300,542,89842,49.89
1536,172,MUKESH SONGARA,Bahujan Samaj Party,1391,7,1398,0.78
1537,172,RAJVEER SINGH RAJENDRA SINGH BAGHEL,Indian National Congress,85120,580,85700,47.59
1538,172,JAHUR KHAN MANSURI,Independent,858,1,859,0.48
1539,172,DEVRAJ RAWAT,Independent,291,2,293,0.16
1540,172,NARENDRA GUPTA,Independent,196,0,196,0.11
1541,172,VINOD CHODHARY,Independent,361,2,363,0.2
1542,172,SURAJ SINGH,Independent,372,0,372,0.21
1543,172,NOTA,None of the Above,1051,8,1059,0.59
1544,176,KUNWAR VIJAY SHAH,Bharatiya Janata Party,116220,360,116580,64.27
1545,176,VIJAYSINGH UIKE,Bahujan Samaj Party,2185,7,2192,1.21
1546,176,SUKHRAM SALVE,Indian National Congress,56247,337,56584,31.2
1547,176,BINDYA BAI GOPICHAND PATEL,Independent,1709,8,1717,0.95
1548,176,MAHENDRA KUMARA KALU RAM BADAI,Independent,1247,3,1250,0.69
1549,176,NOTA,None of the Above,3058,3,3061,1.69
1550,135,Kamal Patel,Bharatiya Janata Party,93275,408,93683,47.66
1551,135,PRHLAD PENTAR,Bahujan Samaj Party,1159,7,1166,0.59
1552,135,DR. RAMKISHORE DOGNE,Indian National Congress,93485,1068,94553,48.1
1553,135,PARASHRAM HIRE,Janata Congress,885,2,887,0.45
1554,135,SUNIL KUMAR,Aam Bhartiya Party,171,0,171,0.09
1555,135,Sohan UMariya,Aazad Samaj Party (Kanshi Ram),650,5,655,0.33
1556,135,GEETA KAMAL PANDE,Independent,129,1,130,0.07
1557,135,YOGITA KANTARAM DUDHWAL,Independent,164,0,164,0.08
1558,135,RAJESH KARMA,Independent,1514,6,1520,0.77
1559,135,Rohit Sodhe (Pammi),Independent,870,0,870,0.44
1560,135,ADV. LOKESH KUMAR TIWARI (LUCKY),Independent,412,2,414,0.21
1561,135,NOTA,None of the Above,2341,16,2357,1.2
1562,17,NARAYAN SiNGH KUSHWAH,Bharatiya Janata Party,81632,685,82317,49.4
1563,17,PANKAJ KUMAR GUPTA,Aam Aadmi Party,1002,24,1026,0.62
1564,17,PRAVEEN PATHAK,Indian National Congress,78775,1006,79781,47.88
1565,17,SADDO ASHOK KHAN,Bahujan Samaj Party,1241,11,1252,0.75
1566,17,KALYAN SINGH KUSHWAH,Aazad Samaj Party (Kanshi Ram),358,1,359,0.22
1567,17,GOPAL JAYASWAL,Independent,156,2,158,0.09
1568,17,DEVENDRA KUSHWAH,Independent,58,4,62,0.04
1569,17,NARAYAN SINGH KUSHAWAH,Independent,166,6,172,0.1
1570,17,RAJENDRA SINGH KUSHAWAH,Independent,143,1,144,0.09
1571,17,VIJAY MAHOR,Independent,236,0,236,0.14
1572,17,NOTA,None of the Above,1103,18,1121,0.67
1573,14,Bharat Singh Kushwah,Bharatiya Janata Party,76286,273,76559,40.6
1574,14,SAHAB SINGH GURJAR,Indian National Congress,79321,520,79841,42.34
1575,14,Er Sumit Pal,Aam Aadmi Party,868,6,874,0.46
1576,14,SuRESH BAGHEL,Bahujan Samaj Party,26931,59,26990,14.31
1577,14,JEEVAN KuSHWAH,Rashtriya Samanta Dal,343,0,343,0.18
1578,14,DR. RANDHIR SINGH RUHAL,Rashtra Nirman Party,122,3,125,0.07
1579,14,RAJESH KUSHWAH,Aazad Samaj Party (Kanshi Ram),231,1,232,0.12
1580,14,RAJESH SHANKAR KAKKA,Samajwadi Party,271,2,273,0.14
1581,14,UDAYVEER SINGH,Independent,75,1,76,0.04
1582,14,GENDA LAL,Independent,114,0,114,0.06
1583,14,TeJendra Mishra,Independent,116,0,116,0.06
1584,14,Deependra Singh Parmar,Independent,95,0,95,0.05
1585,14,DHARMVEER GURJAR,Independent,189,0,189,0.1
1586,14,shree NARESH CHANDrA SHARMA,Independent,145,1,146,0.08
1587,14,NITESH SINGH,Independent,347,0,347,0.18
1588,14,PURAN SiNGH,Independent,765,0,765,0.41
1589,14,MAN SINGH,Independent,493,1,494,0.26
1590,14,Ravi Joshi,Independent,360,0,360,0.19
1591,14,LOKENDRA SINGH GURJAR,Independent,140,0,140,0.07
1592,14,SANDEEP SINGH GURJAR,Independent,169,1,170,0.09
1593,14,NOTA,None of the Above,306,5,311,0.16
1594,16,PRAHLAD SINGH PRAKASH TAILAR,Bahujan Samaj Party,4164,62,4226,2.18
1595,16,MAYA SINGH (MAMI JI),Bharatiya Janata Party,83956,992,84948,43.89
1596,16,DR SATISH SIKARWAR,Indian National Congress,98450,1851,100301,51.83
1597,16,NAROTTAM JATAV,Aazad Samaj Party (Kanshi Ram),940,3,943,0.49
1598,16,PRADEEP SHARMA,Jan Adhikar Party,163,4,167,0.09
1599,16,VIJAY BAUDDH,Ambedkarite Party of India,197,2,199,0.1
1600,16,VINOD KARANA,Samajwadi Party,317,19,336,0.17
1601,16,HEMLATA MUKESH KOLI,National Youth Party,76,2,78,0.04
1602,16,PROF. Dr. P.D. AGARWAL,Independent,156,3,159,0.08
1603,16,DEEPAK KUMAR SEN,Independent,121,2,123,0.06
1604,16,SHREE NARESH CHANDRA,Independent,55,0,55,0.03
1605,16,NATHU SINGH,Independent,105,12,117,0.06
1606,16,MAHESH PAL KATARIYA,Independent,142,0,142,0.07
1607,16,MINAKSHI JAIN,Independent,195,2,197,0.1
1608,16,VISHAL PAL,Independent,214,1,215,0.11
1609,16,NOTA,None of the Above,1301,23,1324,0.68
1610,15,NiTiN SiNGH TOMAR (MONTY),Bahujan Samaj Party,1249,11,1260,0.64
1611,15,PRADHUMAN SiNGH TOMAR,Bharatiya Janata Party,103861,914,104775,52.92
1612,15,ROHIT GUPTA,Aam Aadmi Party,1792,24,1816,0.92
1613,15,SuNIL SHARMA,Indian National Congress,84357,1278,85635,43.26
1614,15,ARTI BHASKARAN BANTHOLIYA,Akhand Bharat Samrajya Party,327,1,328,0.17
1615,15,IMRAN KHAN,Aazad Samaj Party (Kanshi Ram),300,2,302,0.15
1616,15,ADVOCATE KAUSHAL SHARMA,Communist Party of India,343,0,343,0.17
1617,15,DEVI PRASAD VERMA,Indian Peoples Adhikar Party,47,0,47,0.02
1618,15,ADVOCATE MAHESH KOLi,Swatantra Jantaraj Party,352,10,362,0.18
1619,15,Comrade Mitalee Shukla,Socialist Unity Centre Of India (COMMUNIST),163,4,167,0.08
1620,15,RAJVEER DHAKAR,Public Political Party,47,6,53,0.03
1621,15,ROSHAN BEG,Samatamoolak Samaj Party,197,0,197,0.1
1622,15,Chandan Rathore,Independent,145,1,146,0.07
1623,15,JITENDRA TRiPATHi,Independent,106,0,106,0.05
1624,15,SMT. NiDHi SHARMA,Independent,434,0,434,0.22
1625,15,PAVAN SiNGH,Independent,367,1,368,0.19
1626,15,MANEESH KALE,Independent,168,1,169,0.09
1627,15,MANiSH SiNGHAL,Independent,376,0,376,0.19
1628,15,SUNiL SHARMA,Independent,177,7,184,0.09
1629,15,NOTA,None of the Above,886,19,905,0.46
1630,75,"KAPIDHWAJ SINGH ""BHAIYA SAHEB""",Indian National Congress,65624,598,66222,40.11
1631,75,NAGENDRA SINGH,Bharatiya Janata Party,68466,249,68715,41.62
1632,75,PRAKHAR PRATAP SINGH,Aam Aadmi Party,2198,15,2213,1.34
1633,75,SMT. SAROJ RAVIND KOL,Bahujan Samaj Party,18270,78,18348,11.11
1634,75,ADVOCATE AMARJEET KUSHWAHA,Jan Adhikar Party,373,0,373,0.23
1635,75,AMRESH PATEL,Samajwadi Party,1330,7,1337,0.81
1636,75,DHERENDRA SINGH PATEL,Bhartiya Shakti Chetna Party,328,0,328,0.2
1637,75,MUL NIWASI YAGYA NIWAS YADAV,Peoples Party of India (Democratic),240,1,241,0.15
1638,75,LALMANI TRIPATHI,Communist Party of India,1506,10,1516,0.92
1639,75,VIJAY MISHRA,Jan Sewa Driver Party,254,0,254,0.15
1640,75,PD. SHIVAMOHAN SHARMA,Rashtravadi Bharat Party,251,0,251,0.15
1641,75,MOHD. JUMMAN,Independent,166,0,166,0.1
1642,75,DAYA SHANKAR PANDEY,Independent,353,1,354,0.21
1643,75,DHINENDRA (GIRDHAR),Independent,260,0,260,0.16
1644,75,BRIJENDRA MISHRA,Independent,939,0,939,0.57
1645,75,RANNU LAL SAKET,Independent,1297,0,1297,0.79
1646,75,RAKESH KUMAR PANDEY,Independent,878,0,878,0.53
1647,75,RAM JIYAWAN GUPTA,Independent,712,0,712,0.43
1648,75,RAM NIWASH VISVAKARMA,Independent,137,0,137,0.08
1649,75,LALAN PRASAD SAKET (MANEJAR),Independent,273,0,273,0.17
1650,75,NOTA,None of the Above,285,5,290,0.18
1651,59,JEEVAN LAL SIDDHARTH,Indian National Congress,75183,853,76036,45.2
1652,59,DEVIDEEN 'ASHU',Bahujan Samaj Party,5927,19,5946,3.53
1653,59,RAJESH KUMAR VERMA,Bharatiya Janata Party,76907,289,77196,45.89
1654,59,AMITA BAGRI,Samajwadi Party,3874,18,3892,2.31
1655,59,ARViND- BAGRI,Vindhya Janta Party,495,3,498,0.3
1656,59,JEETENDRA KUMAR DAHAYAT,Jan Adhikar Party,438,3,441,0.26
1657,59,SHRI - POORAN LAL KORI,Peoples Party of India (Democratic),595,3,598,0.36
1658,59,PARSU CHAUDHARY,Independent,778,1,779,0.46
1659,59,SANT LAL PRAJAPATI URF- TIGER,Independent,808,1,809,0.48
1660,59,NOTA,None of the Above,2008,4,2012,1.2
1661,29,Ad. JAGVEER SINGH JARSONIYA,Bahujan Samaj Party,3424,44,3468,2.01
1662,29,PANNA LAL SHAKYA,Bharatiya Janata Party,113433,1368,114801,66.59
1663,29,PANKAJ KANERIYA,Indian National Congress,47083,1264,48347,28.05
1664,29,KAMAL SiNGH AHiRWAR,Lok Samaj Party,640,4,644,0.37
1665,29,ADV. DINESH KUMAR JATAV,Aazad Samaj Party (Kanshi Ram),652,6,658,0.38
1666,29,SEEMA RAI,Socialist Unity Centre Of India (COMMUNIST),609,13,622,0.36
1667,29,GoUTEM SHAKYA,Independent,297,1,298,0.17
1668,29,HARIOM KHATEEK,Independent,1814,14,1828,1.06
1669,29,NOTA,None of the Above,1687,35,1722,1
1670,154,UMA DEVI,Bahujan Samaj Party,2492,60,2552,1.02
1671,154,KRISHNA GAUR,Bharatiya Janata Party,171318,1841,173159,68.96
1672,154,"RAVINDRA SAHU ""JHOOMARWALA""",Indian National Congress,65294,1197,66491,26.48
1673,154,SAJJAN SINGH PARMAR,Aam Aadmi Party,3524,78,3602,1.43
1674,154,AJAY VERMA,Rashtravadi Bharat Party,116,0,116,0.05
1675,154,AANAND JAIN,Indian Peoples Adhikar Party,436,5,441,0.18
1676,154,INDRAL KUMAR BID,Bhartiya Gan Varta Party,94,0,94,0.04
1677,154,BHAVESH BAMANIYA,Right to Recall Party,103,0,103,0.04
1678,154,MANOJ KUMAR,Bhartiya Shakti Chetna Party,92,0,92,0.04
1679,154,MRIDALINI SINGH SANGAR,Vastavik Bharat Party,179,1,180,0.07
1680,154,VINOD LOGARIA,Socialist Unity Centre Of India (COMMUNIST),134,5,139,0.06
1681,154,DR. VIVEK PARIHAR,Samajwadi Party,199,1,200,0.08
1682,154,ABDUL TAHIR ADVOCATE (BABLU RAJNIKANT),Independent,116,1,117,0.05
1683,154,MUDIT CHAURASIA,Independent,194,2,196,0.08
1684,154,RAMSWAROOP SINGH KHALSA,Independent,260,1,261,0.1
1685,154,VISHAL BINDAL,Independent,513,1,514,0.2
1686,154,HITENDRA SHAHARE,Independent,295,5,300,0.12
1687,154,NOTA,None of the Above,2506,55,2561,1.02
1688,118,NARMADA PRASAD PRAJAPATI (N.P.),Indian National Congress,43453,496,43949,24.18
1689,118,MAHENDRA NAGESH,Bharatiya Janata Party,91356,381,91737,50.46
1690,118,JYOTI CHOUDHARY,Vastavik Bharat Party,1300,3,1303,0.72
1691,118,"Neelesh Dohaiya ""JAY BHIM""",Aazad Samaj Party (Kanshi Ram),509,4,513,0.28
1692,118,PARAMLAL URF GOLI CHOUDHARY,Janseva Gondwana Party,471,4,475,0.26
1693,118,PRAMOD KUMAR MEHRA (JHARIYA) P.T.,Janata Dal (United),239,3,242,0.13
1694,118,SURESH KUMAR MEHRA,Gana Suraksha Party,538,2,540,0.3
1695,118,THAKUR SURESH JHARIYA,Gondvana Gantantra Party,3304,6,3310,1.82
1696,118,"DEVENDRA CHOUDHARY ""TINKU BHAIYA""",Independent,815,1,816,0.45
1697,118,SHEKHAR CHOUDHARY,Independent,35614,404,36018,19.81
1698,118,NOTA,None of the Above,2877,13,2890,1.59
1699,13,Keshav Desai,Indian National Congress,69352,589,69941,47.32
1700,13,YASHWANT PATWARI,Aam Aadmi Party,1361,5,1366,0.92
1701,13,LAL SINGH ARYA,Bharatiya Janata Party,68991,343,69334,46.91
1702,13,SURESH SINGH SHOLANKEE,Bahujan Samaj Party,2909,10,2919,1.98
1703,13,ANIL GARG,Ambedkarite Party of India,289,3,292,0.2
1704,13,ANITA KAMAL NAGAR,Aazad Samaj Party (Kanshi Ram),1238,7,1245,0.84
1705,13,DR. MOHAN LAL MAHOR,Samajwadi Party,443,1,444,0.3
1706,13,SONU SEVERIYA,Jai Prakash Janata Dal,104,0,104,0.07
1707,13,Anil Kumar,Independent,103,0,103,0.07
1708,13,Anshul Bansal,Independent,97,0,97,0.07
1709,13,KALYAN SINGH,Independent,119,4,123,0.08
1710,13,G.P. KHANNA,Independent,152,0,152,0.1
1711,13,NARYAN BHARTI,Independent,144,1,145,0.1
1712,13,Rajkumar,Independent,325,0,325,0.22
1713,13,Sanjay Jatav,Independent,416,0,416,0.28
1714,13,NOTA,None of the Above,789,1,790,0.53
1715,132,GANGA SAJJAN SINGH UIKEY,Bharatiya Janata Party,103378,332,103710,47.38
1716,132,RAHUL UIKEY,Indian National Congress,98666,831,99497,45.45
1717,132,KAUSHAL KISHORE PARTETY,Gondvana Gantantra Party,2817,6,2823,1.29
1718,132,BHIKARILAL YUVNATE,Kranti Janshakti Party,680,6,686,0.31
1719,132,KALLUSINGH KUMRE,Independent,303,1,304,0.14
1720,132,CHUNNEELAL DHURVE,Independent,404,3,407,0.19
1721,132,BHUTA SINGH EVNE(B.S.EVNE),Independent,535,1,536,0.24
1722,132,BARSKAR SUBHASH,Independent,798,1,799,0.36
1723,132,SMITA RAJA DHURVE,Independent,6112,38,6150,2.81
1724,132,NOTA,None of the Above,3992,5,3997,1.83
1725,215,JEEVAN SINGH DEWDA,Bahujan Samaj Party,2204,8,2212,1.2
1726,215,RAMLAL MALVIYA,Indian National Congress,78142,428,78570,42.68
1727,215,SATISH MALVIYA,Bharatiya Janata Party,96004,232,96236,52.27
1728,215,RAVI GUJRATI,Aazad Samaj Party (Kanshi Ram),3666,5,3671,1.99
1729,215,BALU-SINGH,Independent,329,1,330,0.18
1730,215,MADANLAL MIMROT (EX.TEHSILDAR),Independent,714,0,714,0.39
1731,215,RAMESH PILOT,Independent,1105,3,1108,0.6
1732,215,NOTA,None of the Above,1254,3,1257,0.68
1733,227,CHANDAR SINGH SISODIYA,Bharatiya Janata Party,108030,572,108602,52.81
1734,227,JAGDISH RANGOTHA,Bahujan Samaj Party,1662,6,1668,0.81
1735,227,SUBHASH KUMAR SOJATIA,Indian National Congress,89355,1140,90495,44
1736,227,PRAHALAD SINGH CHOUHAN,Independent,1352,1,1353,0.66
1737,227,PHULACHAND,Independent,445,1,446,0.22
1738,227,SAEED AHAMAD,Independent,605,1,606,0.29
1739,227,SURESH DHAKAD,Independent,538,1,539,0.26
1740,227,NOTA,None of the Above,1933,16,1949,0.95
1741,197,UMANG SINGHAR,Indian National Congress,98123,859,98982,54.01
1742,197,DHUMSINGH MANDLOI (MACHHAR),Bahujan Samaj Party,2032,9,2041,1.11
1743,197,SARDAR SINGH MEDA,Bharatiya Janata Party,76494,369,76863,41.94
1744,197,SUMANBAI BHERUSINGH ANARE,Aam Aadmi Party,2283,13,2296,1.25
1745,197,NOTA,None of the Above,3064,5,3069,1.67
1746,121,UDAY PRATAP SINGH,Bharatiya Janata Party,111113,698,111811,62.5
1747,121,SAVITA BAI AHIRWAR,Bahujan Samaj Party,3958,15,3973,2.22
1748,121,SUNITA PATEL,Indian National Congress,54324,958,55282,30.9
1749,121,CHHOTE BHAI GURJAR,Bhartiya Veer Dal,945,1,946,0.53
1750,121,POONAM SINGH BHARVE,Kranti Janshakti Party,1663,4,1667,0.93
1751,121,ARVIND RAI,Independent,264,3,267,0.15
1752,121,ARYA RAVI PARIHAR,Independent,439,2,441,0.25
1753,121,KAPIL DUBAY,Independent,915,4,919,0.51
1754,121,SUNITA PATEL,Independent,640,9,649,0.36
1755,121,NOTA,None of the Above,2923,18,2941,1.64
1756,209,ARUN SINGH CHOUHAN (ARUN CHOUHAN),Communist Party of India (Marxist),975,3,978,0.45
1757,209,USHA BABU SINGH THAKUR,Bharatiya Janata Party,102130,859,102989,47.1
1758,209,KAILASH UTAWAL,Bahujan Samaj Party,780,3,783,0.36
1759,209,RAMKISHORE SHUKLA 'BHAIYAJI',Indian National Congress,28660,484,29144,13.33
1760,209,SUNIL CHOUDHARY,Aam Aadmi Party,912,7,919,0.42
1761,209,KISHOR MALVIYA,Aazad Samaj Party (Kanshi Ram),1001,4,1005,0.46
1762,209,MAHESH PANCHULAL YADAV,Bahujan Mukti Party,328,2,330,0.15
1763,209,VICKAS YADAV,Janata Congress,436,0,436,0.2
1764,209,ANTAR SINGH DARBAR,Independent,68055,542,68597,31.37
1765,209,ABHISHEK MAHESH VERMA,Independent,536,3,539,0.25
1766,209,PRADEEP MAVI JAYS,Independent,11304,90,11394,5.21
1767,209,NOTA,None of the Above,1538,15,1553,0.71
1768,104,OMKAR SINGH MARKAM,Indian National Congress,92756,1190,93946,45.11
1769,104,PANKAJ SINGH TEKAM,Bharatiya Janata Party,81207,474,81681,39.22
1770,104,CHANDRASINGH KUSHRAM,Bhartiya Shakti Chetna Party,2619,3,2622,1.26
1771,104,CHARAN SINGH DHURVE,Gondvana Gantantra Party,5151,28,5179,2.49
1772,104,DINESH KUMAR DHURWEY,Rashtriya Gondvana Party,925,7,932,0.45
1773,104,Smt. DHUNESHWARI ASHOK DHURWAY,Narmadakhand Navnirman Sena,670,3,673,0.32
1774,104,SITAR MARKAM,Vindhya Janta Party,827,1,828,0.4
1775,104,RUDESH PARASTE,Independent,18057,137,18194,8.74
1776,104,NOTA,None of the Above,4178,8,4186,2.01
1777,7,NARENDRA SINGH TOMAR,Bharatiya Janata Party,78739,398,79137,48.94
1778,7,BALVEER SINGH DANDOTIYA,Bahujan Samaj Party,54310,366,54676,33.81
1779,7,Ravindra Singh Tomar Bhidosa,Indian National Congress,23690,316,24006,14.84
1780,7,Surendra Singh Tomar,Aam Aadmi Party,670,5,675,0.42
1781,7,DEEPAK KUSHWAH,Jan Adhikar Party,145,0,145,0.09
1782,7,MAHESH AGRWAL MAMA,Samajwadi Party,744,4,748,0.46
1783,7,RAVINDRA SINGH KUSHWAH,Rashtriya Samanta Dal,112,2,114,0.07
1784,7,RAJESH KUSHWAH (GOUTAM) GHURGHAN WALE,Bahujan Mukti Party,113,0,113,0.07
1785,7,Dhirendra Sharma,Independent,85,0,85,0.05
1786,7,BRAJENDRA SINGH,Independent,89,0,89,0.06
1787,7,RAJVEER SINGH,Independent,131,0,131,0.08
1788,7,RAMKUMAR 'DADDA',Independent,124,0,124,0.08
1789,7,SHAKIL MOhMMAD,Independent,225,0,225,0.14
1790,7,Saurabh Sharma,Independent,667,1,668,0.41
1791,7,NOTA,None of the Above,776,2,778,0.48
1792,82,Kamlesh Singh,Indian National Congress,77992,750,78742,42.36
1793,82,Kunwar Singh Tekam,Bharatiya Janata Party,81875,188,82063,44.14
1794,82,Pragya Singh,Jan Adhikar Party,2065,0,2065,1.11
1795,82,Raju Prasad Panika,Bhartiya Shakti Chetna Party,1119,4,1123,0.6
1796,82,Laldev Singh Kusharam,Gondvana Gantantra Party,11693,31,11724,6.31
1797,82,Vishwanath Singh Markam,Samajwadi Party,837,4,841,0.45
1798,82,Savita Vishwanath Singh Markam,Aapka Gantantra Party,359,0,359,0.19
1799,82,"""Moolniwasi"" Heeralal Tandiya",Peoples Party of India (Democratic),1167,7,1174,0.63
1800,82,Neeta Kol,Independent,626,3,629,0.34
1801,82,Prem Lal Baiga,Independent,1123,1,1124,0.6
1802,82,Bansh Gopal Singh,Independent,820,0,820,0.44
1803,82,Ram Singh S/o Karan Singh,Independent,1783,0,1783,0.96
1804,82,NOTA,None of the Above,3457,2,3459,1.86
1805,200,KALUSINGH THAKUR,Bharatiya Janata Party,83897,310,84207,47.76
1806,200,PANCHILAL MEDA,Indian National Congress,83206,645,83851,47.56
1807,200,CHOUHAN RAJU BEN,Independent,3953,11,3964,2.25
1808,200,Er. SANTOSH MAKRANI KATARE,Independent,742,4,746,0.42
1809,200,SHRIRAM DAWAR,Independent,1084,2,1086,0.62
1810,200,NOTA,None of the Above,2451,4,2455,1.39
1811,201,Omprakash Malviy,Bahujan Samaj Party,1006,2,1008,0.49
1812,201,Neena Vikram Verma,Bharatiya Janata Party,89924,447,90371,44.08
1813,201,Prabha Balmukund Gautam,Indian National Congress,79848,829,80677,39.35
1814,201,Abdul Salam,Public Political Party,741,0,741,0.36
1815,201,Kuldeep Mohan singh bundela,Independent,6907,41,6948,3.39
1816,201,Jamila Bee,Independent,234,0,234,0.11
1817,201,Deep Singh Thakur,Independent,105,2,107,0.05
1818,201,Manoj Tanwar,Independent,436,0,436,0.21
1819,201,Mamta Rajput,Independent,968,1,969,0.47
1820,201,Rajeev Yadav-Raju,Independent,21018,96,21114,10.3
1821,201,Rajesh Rathore,Independent,604,0,604,0.29
1822,201,Hariram Patel Delmiwala,Independent,624,2,626,0.31
1823,201,NOTA,None of the Above,1188,10,1198,0.58
1824,171,GAYATRI RAJE PUAR,Bharatiya Janata Party,116520,902,117422,55.33
1825,171,PRADEEP CHOUDHARY,Indian National Congress,89527,939,90466,42.63
1826,171,ADVOCATE RAJUL SHRIVASTAVA,Socialist Unity Centre Of India (COMMUNIST),495,5,500,0.24
1827,171,CHANA GNANESH,Independent,341,7,348,0.16
1828,171,MUNNI SETH RAJENDRA SHARMA,Independent,191,3,194,0.09
1829,171,SHRAVAN SINGH,Independent,1855,4,1859,0.88
1830,171,NOTA,None of the Above,1408,14,1422,0.67
1831,81,BANSHMANI PRASAD VERMA,Indian National Congress,65791,415,66206,34.4
1832,81,RATIBHAN PRASAD,Aam Aadmi Party,4405,18,4423,2.3
1833,81,RAJENDRA MESHRAM,Bharatiya Janata Party,88479,181,88660,46.07
1834,81,SHIV SHANKAR PRASAD,Bahujan Samaj Party,17006,22,17028,8.85
1835,81,DINESH KUMAR,Bhartiya Krantisangh Party,635,1,636,0.33
1836,81,PRAMILA VARMA,Peoples Party of India (Democratic),817,1,818,0.43
1837,81,RAMDIN SAKET,Saman Aadmi Saman Party,485,0,485,0.25
1838,81,LALPATI SAKET,Gondvana Gantantra Party,2982,9,2991,1.55
1839,81,SHIVKALI SAKET,Communist Party of India,2936,2,2938,1.53
1840,81,Dr. SUSHMA PRAJAPATI,Samajwadi Party,2582,7,2589,1.35
1841,81,SHRINIVAS PRAJAPATI,Bhartiya Shakti Chetna Party,1414,2,1416,0.74
1842,81,ANARKALI PRAJAPATI,Independent,1006,1,1007,0.52
1843,81,NOTA,None of the Above,3237,4,3241,1.68
1844,203,ANKUR MISHRA,Bahujan Samaj Party,829,2,831,0.38
1845,203,MANOJ NIRBHAY SINGH PATEL,Bharatiya Janata Party,94989,588,95577,43.14
1846,203,VISHAL JAGDISH PATEL,Indian National Congress,81097,782,81879,36.96
1847,203,SOHAN DEVISINGH SOLANKI,Bahujan Mukti Party,1235,7,1242,0.56
1848,203,INTEKHAB ALAM URF MALIK KHAN (SIR),Independent,207,0,207,0.09
1849,203,ILYAS ALI,Independent,111,0,111,0.05
1850,203,CHETAN BAIRAGI,Independent,278,2,280,0.13
1851,203,JAGDISH URF LAKHAN PACHARANGIYA,Independent,768,7,775,0.35
1852,203,PANKAJ NEGI,Independent,123,4,127,0.06
1853,203,MANOJ PATEL,Independent,408,5,413,0.19
1854,203,RAJENDRA VIKRAMSINGH CHOUDHARY,Independent,37741,179,37920,17.12
1855,203,RAHUL,Independent,586,0,586,0.26
1856,203,VIJAY PARMAR,Independent,454,0,454,0.2
1857,203,NOTA,None of the Above,1145,6,1151,0.52
1858,72,AMARNATH-PATEL URAF-W-BHIYA,Bahujan Samaj Party,30114,137,30251,19.46
1859,72,GIRISH GAUTAM,Bharatiya Janata Party,63385,337,63722,40.99
1860,72,"DILEEP SINGH ""GUDU BHAIYA""",Aam Aadmi Party,1749,7,1756,1.13
1861,72,PADMESH GAUTAM,Indian National Congress,38767,569,39336,25.3
1862,72,ASHA TIWARI,Bhartiya Shakti Chetna Party,672,0,672,0.43
1863,72,POOJA PATEL,Peoples Party of India (Democratic),209,4,213,0.14
1864,72,BANS ROOP KATHEL,Bhagidari Party(P),187,0,187,0.12
1865,72,RAHUL DEO SAKET,Bahujan Mukti Party,196,1,197,0.13
1866,72,SATEESH TIWARI URAF SATEESH BHAIYA,Vindhya Janta Party,328,1,329,0.21
1867,72,SEEMA JAIVEER SINGH SENGAR,Samajwadi Party,14100,52,14152,9.1
1868,72,KALPANA RAWAT,Independent,472,6,478,0.31
1869,72,CHOTTE LAL SINGH GODE(TEKAM) KADDI,Independent,425,1,426,0.27
1870,72,MAHESH PRASAD KORI,Independent,526,1,527,0.34
1871,72,RAJ KUMAR PATEL,Independent,423,1,424,0.27
1872,72,ADV. RAMYAGYA SONDHIYA,Independent,1607,6,1613,1.04
1873,72,NOTA,None of the Above,1172,4,1176,0.76
1874,38,"BRIJBIHARI PATERIYA""GUDDA BHAIYA""",Bharatiya Janata Party,94529,403,94932,55.17
1875,38,HARSH YADAV,Indian National Congress,67111,598,67709,39.35
1876,38,ARVINDRA DIXIT,Bhartiya Shakti Chetna Party,1709,0,1709,0.99
1877,38,KAMTA PRASAD,Aazad Samaj Party (Kanshi Ram),509,0,509,0.3
1878,38,RAJAT DIWAN,Gondvana Gantantra Party,3135,8,3143,1.83
1879,38,ADVOCATE DEVENDRA SINGH LODHI RASHTRIY KRANTI SENA,Independent,257,0,257,0.15
1880,38,PRAHLAD SINGH (GARHA WALE),Independent,454,3,457,0.27
1881,38,BALCHAND,Independent,415,1,416,0.24
1882,38,MUKESH RAJAK,Independent,486,1,487,0.28
1883,38,RANU LODHI,Independent,806,0,806,0.47
1884,38,NOTA,None of the Above,1633,9,1642,0.95
1885,22,Dr. NAROTTAM MiSHRA,Bharatiya Janata Party,80492,743,81235,45.96
1886,22,BHARTI RAJENDRA,Indian National Congress,87648,1329,88977,50.34
1887,22,LOKENDRA NETAJI,Bahujan Samaj Party,1150,6,1156,0.65
1888,22,USHA AHiRWAR,Samatamoolak Samaj Party,122,2,124,0.07
1889,22,AAZAD DESHRAJ PABYA,Aazad Samaj Party (Kanshi Ram),489,1,490,0.28
1890,22,KAPTAN SINGH PARMAR,Independent,90,1,91,0.05
1891,22,C L BAUDH CHHOTE LAL,Independent,81,0,81,0.05
1892,22,PANDIT MAHESH CHAND SHASTRI,Independent,88,1,89,0.05
1893,22,RAJNI LiTORiYA,Independent,129,1,130,0.07
1894,22,RAVI DANGI,Independent,97,2,99,0.06
1895,22,RAJU KHAN,Independent,117,1,118,0.07
1896,22,RAMNARESH DANGI,Independent,205,0,205,0.12
1897,22,RAMSINGH SENGAR,Independent,185,1,186,0.11
1898,22,SHISHIR KHARE,Independent,271,1,272,0.15
1899,22,R SiNGH,Independent,748,0,748,0.42
1900,22,HARDAS KUSHWAH,Independent,1306,0,1306,0.74
1901,22,NOTA,None of the Above,1443,9,1452,0.82
1902,55,AJAY KUMAR TANDON,Indian National Congress,59821,1106,60927,32.44
1903,55,CHAHAT PANDEY,Aam Aadmi Party,2275,17,2292,1.22
1904,55,JAYANT MALAIYA,Bharatiya Janata Party,111449,829,112278,59.79
1905,55,PRATAP ROHIT (AHIRWAR),Bahujan Samaj Party,3146,32,3178,1.69
1906,55,DOLAT SINGH LODHI,Bhartiya Shakti Chetna Party,2482,11,2493,1.33
1907,55,DRAGPAL SINGH LODHI,Samajwadi Party,904,6,910,0.48
1908,55,NARENDRA /AACHARYA POORAN SINGH LODHI,Pichhara Samaj Party United,86,1,87,0.05
1909,55,NAVEEN BOUDH,Aazad Samaj Party (Kanshi Ram),674,2,676,0.36
1910,55,AJAY BHAIYA,Independent,139,1,140,0.07
1911,55,AJAY KUMAR,Independent,120,9,129,0.07
1912,55,JAYANT,Independent,124,0,124,0.07
1913,55,JAYANT KUMAR,Independent,158,1,159,0.08
1914,55,JAYANT BHAIYA,Independent,306,0,306,0.16
1915,55,"""NISHANT PATHAK NIKKI BHAIYA""",Independent,811,1,812,0.43
1916,55,RAHUL,Independent,427,0,427,0.23
1917,55,RAHUL BHAIYA,Independent,858,0,858,0.46
1918,55,RAHUL BHAIYA,Independent,659,1,660,0.35
1919,55,"RICHA PURSHOTTAM CHOUBEY ""HARI OM""",Independent,173,1,174,0.09
1920,55,SHAHRUKH KHAN MANSOORI (NETAJI),Independent,643,0,643,0.34
1921,55,NOTA,None of the Above,517,11,528,0.28
1922,19,IMARTI DEVI,Bharatiya Janata Party,82092,358,82450,46.79
1923,19,SMT SATYAPRAKASHI PARSEDIYA,Bahujan Samaj Party,4392,45,4437,2.52
1924,19,SURESH RAJE,Indian National Congress,83917,800,84717,48.08
1925,19,PAWAN KUMAR RAI,Rashtriya Rakshak Morcha,941,1,942,0.53
1926,19,Dr. Bharat Warsi,Jan Adhikar Party,143,1,144,0.08
1927,19,ROOPESH KAIN,Aazad Samaj Party (Kanshi Ram),625,8,633,0.36
1928,19,ANiL Agraiya,Independent,147,0,147,0.08
1929,19,NAVAL KISHOR MOURYA,Independent,167,0,167,0.09
1930,19,RAMVARAN SAGAR,Independent,157,0,157,0.09
1931,19,LEELADHAR,Independent,219,0,219,0.12
1932,19,VIKASH SAGAR,Independent,322,0,322,0.18
1933,19,SANJAY AGARIYA,Independent,301,0,301,0.17
1934,19,NOTA,None of the Above,1555,9,1564,0.89
1935,76,AJAY ARJUN SINGH,Indian National Congress,96457,1060,97517,51.66
1936,76,"Anendra Govind Mishra ""Rajan""",Aam Aadmi Party,8121,79,8200,4.34
1937,76,BABLU VISHWAKARMA,Bahujan Samaj Party,1855,11,1866,0.99
1938,76,SHARADENDU TIWARI,Bharatiya Janata Party,69333,407,69740,36.95
1939,76,ARUN KUMAR BHAI SAHAB,Vindhya Janta Party,1082,5,1087,0.58
1940,76,ANAND PANDEY,Communist Party of India,718,2,720,0.38
1941,76,"BHUPENDRA DWIVEDI ""RAIDUARIA KALA""",Sapaks Party,220,1,221,0.12
1942,76,"AD. RAGHAVENDRA ""MOOLNIWASI""",Peoples Party of India (Democratic),1026,13,1039,0.55
1943,76,RAJENDRA PRASAD PATEL ADVOCATE,Samajwadi Party,418,1,419,0.22
1944,76,ROHIT KUMAR PATEL,Bhartiya Shakti Chetna Party,628,6,634,0.34
1945,76,ARJUN PRASAD SONDHIYA,Independent,158,0,158,0.08
1946,76,ANURAG SINGH,Independent,402,1,403,0.21
1947,76,DASHRATH PRASAD BAIS,Independent,1307,0,1307,0.69
1948,76,PRADEEP SINGH GOND,Independent,488,0,488,0.26
1949,76,RAGHUNANDAN SINGH,Independent,521,0,521,0.28
1950,76,SUNIL SONI 'NIRDALI',Independent,2724,0,2724,1.44
1951,76,GYANENDRA PRASAD DWIVEDI,Independent,1290,1,1291,0.68
1952,76,NOTA,None of the Above,413,1,414,0.22
1953,124,LAKHAN KUMAR VARMA,Bharatiya Janata Party,72691,333,73024,37.9
1954,124,CHOUDHARY SUJEET MERSINGH,Indian National Congress,80825,788,81613,42.36
1955,124,ISHWAR SINGH TEKAM,Gondvana Gantantra Party,1801,10,1811,0.94
1956,124,KAPIL SONI,Rashtriya Gondvana Party,282,0,282,0.15
1957,124,LODHI VIPIN VERMA,Samajwadi Party,278,1,279,0.14
1958,124,GOPAL SINGH DEHRIYA,Independent,345,0,345,0.18
1959,124,NEERAJ THAKUR (BUNTY PATEL),Independent,19597,84,19681,10.22
1960,124,PAWANSHA SARYAM,Independent,10700,51,10751,5.58
1961,124,MASOOD AHMAD,Independent,381,2,383,0.2
1962,124,RAVI,Independent,387,0,387,0.2
1963,124,LAVKESH DEHRIYA,Independent,311,1,312,0.16
1964,124,LAXMINARAYAN JAGANNATH SINGH LODHI,Independent,609,2,611,0.32
1965,124,VIKRAM,Independent,1110,1,1111,0.58
1966,124,NOTA,None of the Above,2069,3,2072,1.08
1967,79,MAHADEV SINGH,Aam Aadmi Party,6223,7,6230,3.46
1968,79,MANIK SINGH,Indian National Congress,45101,430,45531,25.25
1969,79,RADHA RAVINDRA SINGH,Bharatiya Janata Party,105297,113,105410,58.46
1970,79,CHHOTELAL SINGH PAIGAM,Bhartiya Shakti Chetna Party,3326,1,3327,1.85
1971,79,NAWAL SINGH,Rashtriya Gondvana Party,994,1,995,0.55
1972,79,SHAILENDRA HORIL SINGH,Gondvana Gantantra Party,7800,13,7813,4.33
1973,79,SEEMA PANIKA MOOLNIWASI,Peoples Party of India (Democratic),917,2,919,0.51
1974,79,SHUBHLAL BAIGA,Saman Aadmi Saman Party,1262,2,1264,0.7
1975,79,SHRAWAN KUMAR SINGH,Samajwadi Party,2266,0,2266,1.26
1976,79,NAVABI DEVI,Independent,1580,0,1580,0.88
1977,79,SURYA PRATAP SINGH,Independent,1514,1,1515,0.84
1978,79,NOTA,None of the Above,3462,1,3463,1.92
1979,61,NEELANSHU,Indian National Congress,50393,946,51339,32.99
1980,61,"SUBHASH SHARMA ""DOLI""",Bahujan Samaj Party,31560,237,31797,20.43
1981,61,SURENDRA SINGH GAHARWAR,Bharatiya Janata Party,57649,360,58009,37.27
1982,61,Er. Ashok KUMAR SHUKLA,Vindhya Janta Party,811,1,812,0.52
1983,61,KODU LAL BHARTI,Bahujan Dravida Party,585,0,585,0.38
1984,61,BHAIYAMAN PRAJAPATI BALKHADIYA,Peoples Party of India (Democratic),224,1,225,0.14
1985,61,YOGESH GAUTAM URF GURU GORAKH NATH,Satyanishth Jan Sewak Party,316,1,317,0.2
1986,61,Raja Ram Singh gond,All India Forward Bloc,405,1,406,0.26
1987,61,SARITA JAY PRAKASH KUSHWAHA,Jan Adhikar Party,613,4,617,0.4
1988,61,SANJAY SINGH,Samajwadi Party,6315,32,6347,4.08
1989,61,Sanjeev Shikdar,Nyaydharmsabha,222,1,223,0.14
1990,61,AWADH BIHARI MISHRA,Independent,351,1,352,0.23
1991,61,KRISHNA KISHOR GAUTAM,Independent,366,1,367,0.24
1992,61,BABULAL CHAUDHARY,Independent,1062,1,1063,0.68
1993,61,RAJ KUMAR URF GOLU YADAV,Independent,688,0,688,0.44
1994,61,RAMLAL KORI,Independent,1330,0,1330,0.85
1995,61,NOTA,None of the Above,1152,2,1154,0.74
1996,126,KAMAL NATH,Indian National Congress,129829,2473,132302,56.44
1997,126,THAKUR TRIVIKRAM HIRPACHI,Bahujan Samaj Party,1875,22,1897,0.81
1998,126,VIVEK BUNTY SAHU,Bharatiya Janata Party,94820,888,95708,40.83
1999,126,RAJESH TANTRIK (KUSHWAHA),Ahinsa Samaj Party,865,2,867,0.37
2000,126,AJAY NAGWANSHI,Independent,129,1,130,0.06
2001,126,MOHD. PARVEZ QURESHI,Independent,81,0,81,0.03
2002,126,PRAMILA VERMA,Independent,156,1,157,0.07
2003,126,MUKESH KAKODIYA,Independent,194,4,198,0.08
2004,126,MOHAN BHARTEEY,Independent,388,2,390,0.17
2005,126,SUBHASH SHUKLA,Independent,615,2,617,0.26
2006,126,HARSHA BANODE,Independent,337,2,339,0.14
2007,126,NOTA,None of the Above,1737,4,1741,0.74
2008,51,ALOK CHATURVEDI (PAJJAN BHAIYA),Indian National Congress,69961,759,70720,41.31
2009,51,DEELMANI SINGH URF BABBU RAJA,Bahujan Samaj Party,14128,56,14184,8.29
2010,51,BHAGEERATH PATEL URF BHAGGU BHAIYA,Aam Aadmi Party,2311,10,2321,1.36
2011,51,LALITA YADAV,Bharatiya Janata Party,77371,316,77687,45.38
2012,51,AHIRWAR PREM CHANDRA,Jan Adhikar Party,1461,3,1464,0.86
2013,51,BENI PRASAD CHANSAURIYA,Samajwadi Party,882,12,894,0.52
2014,51,AD. RAJA PRAJAPATI,Sapaks Party,138,0,138,0.08
2015,51,RAMCHARAN (CHARAN) AHIRWAR,Aazad Samaj Party (Kanshi Ram),404,1,405,0.24
2016,51,DWIVEDI JAWAHARLAL,Independent,204,0,204,0.12
2017,51,AHIRWAR DEEPAK,Independent,364,0,364,0.21
2018,51,AGRAWAL MANOJ KUMAR,Independent,258,1,259,0.15
2019,51,NAWAB KHAN,Independent,345,1,346,0.2
2020,51,LALTA YADAV,Independent,424,0,424,0.25
2021,51,HARISHCHANDRA 'RAJ',Independent,437,0,437,0.26
2022,51,NOTA,None of the Above,1344,6,1350,0.79
2023,49,AHIRWAR DILEEP,Bharatiya Janata Party,69536,132,69668,43.14
2024,49,D. D. AHIRWAR (DEENDAYAL),Bahujan Samaj Party,7080,44,7124,4.41
2025,49,ANURAGI HARPRASAD (GOPI MASTER),Indian National Congress,53403,774,54177,33.55
2026,49,AHIRWAR PUSHPENDRA KUMAR,Samajwadi Party,24916,61,24977,15.47
2027,49,YOGESH PRAJAPATI,Jan Adhikar Party,591,0,591,0.37
2028,49,Raja Bhaiya Prajapati,Rashtravadi Bharat Party,690,8,698,0.43
2029,49,Anuragi Laklhan Lal,Lok Janshakti Party(Ram Vilas),648,1,649,0.4
2030,49,PREMCHAND VERMA,Independent,781,2,783,0.48
2031,49,AAHIRWAR RAMDEEN,Independent,692,0,692,0.43
2032,49,NOTA,None of the Above,2133,2,2135,1.32
2033,33,GOPAL SINGH CHAUHAN (DAGGI RAJA),Indian National Congress,62647,649,63296,39.8
2034,33,JAGANNATH SINGH RAGHUWANSHI,Bharatiya Janata Party,84730,334,85064,53.49
2035,33,Adv. VIRENDRA SINGH YADAV,Bahujan Samaj Party,5576,22,5598,3.52
2036,33,RANVEER SINGH ADIWASI,Aazad Samaj Party (Kanshi Ram),1521,4,1525,0.96
2037,33,GAMBHIR AHIRBAR,Independent,131,0,131,0.08
2038,33,GOLU YADAV,Independent,80,0,80,0.05
2039,33,BHANU,Independent,149,0,149,0.09
2040,33,MOHAMMAD JAVED ANSARI (JAPANI),Independent,248,1,249,0.16
2041,33,RAMESH CHAND,Independent,296,0,296,0.19
2042,33,RAJPAL YADAV,Independent,198,0,198,0.12
2043,33,RAMBEER SINGH YADAV,Independent,391,2,393,0.25
2044,33,SOHAN LAL AHIRBAR,Independent,587,1,588,0.37
2045,33,NOTA,None of the Above,1440,12,1452,0.91
2046,30,PRIYANKA PENCHI,Bharatiya Janata Party,109801,453,110254,56.47
2047,30,MAMTA MEENA,Aam Aadmi Party,27259,146,27405,14.04
2048,30,RAJENDRA ViNOD SHARMA,Bahujan Samaj Party,759,4,763,0.39
2049,30,LAKSHMAN SINGH,Indian National Congress,48122,562,48684,24.93
2050,30,PRABHuLAL BHEEL,Bahujan Mukti Party,966,1,967,0.5
2051,30,LAXMINARAYAN (GOLU),Aazad Samaj Party (Kanshi Ram),992,1,993,0.51
2052,30,KAPIL AHIRWAR,Independent,389,1,390,0.2
2053,30,PRIYANKA,Independent,573,3,576,0.3
2054,30,Badɤilal,Independent,477,1,478,0.24
2055,30,MAMTA MEENA,Independent,960,4,964,0.49
2056,30,LAKSHMAN SINGH,Independent,594,3,597,0.31
2057,30,HAR BAI,Independent,926,1,927,0.47
2058,30,NOTA,None of the Above,2248,1,2249,1.15
2059,8,KAMLESH JATAV,Bharatiya Janata Party,57165,581,57746,39.79
2060,8,DEVENDRA RAMNARAYAN SAKHWAR,Indian National Congress,79274,1099,80373,55.38
2061,8,RAMBARAN SAKHAWAR,Bahujan Samaj Party,4146,33,4179,2.88
2062,8,ANITA CHOUDHARY,Samajwadi Party,204,18,222,0.15
2063,8,DHARMENDRA SINGH JATAV,Samata Samadhan Party,81,2,83,0.06
2064,8,DHIR SINGH,Bharatiya Majdoor Janta Party,107,2,109,0.08
2065,8,SURENDRA SINGH SAKHAWAR,Samatamoolak Samaj Party,96,0,96,0.07
2066,8,SOMESH AZAD SAKHAWAR,Aazad Samaj Party (Kanshi Ram),492,3,495,0.34
2067,8,AHIBARAN SINGH SAKHWAR,Independent,93,3,96,0.07
2068,8,DHARMENDRA GOUR,Independent,90,2,92,0.06
2069,8,MUNESH,Independent,102,0,102,0.07
2070,8,VIKASH KIRAR,Independent,272,0,272,0.19
2071,8,VINOD KUMAR,Independent,383,1,384,0.26
2072,8,NOTA,None of the Above,871,13,884,0.61
2073,112,AJAB SHASTRI,Bahujan Samaj Party,7834,90,7924,4.5
2074,112,PRADEEP AMRATLAL JAISWAL (GUDDA),Bharatiya Janata Party,78259,335,78594,44.65
2075,112,VIVEK VICKY PATEL,Indian National Congress,78213,1384,79597,45.22
2076,112,DILENDRA PAGHARE,Bhartiya Shakti Chetna Party,992,3,995,0.57
2077,112,RUPESH KUMAR NAGOTE,Peoples Party of India (Democratic),200,2,202,0.11
2078,112,ER. HIRALAL BHAGAT,Bahujan Mukti Party,156,3,159,0.09
2079,112,CHUNNI BHAU DHUWARE (KALAR),Independent,226,3,229,0.13
2080,112,DEEPAK PINCHA,Independent,191,2,193,0.11
2081,112,MANOJ MEHARBAN [KALAR],Independent,266,1,267,0.15
2082,112,MANOJ LILHARE,Independent,5669,22,5691,3.23
2083,112,Dr. RAMLAL MASRAM,Independent,1195,4,1199,0.68
2084,112,NOTA,None of the Above,949,11,960,0.55
2085,92,NEERAJ DADA,Indian National Congress,73307,357,73664,39.83
2086,92,SANJAY SATYENDRA PATHAK,Bharatiya Janata Party,97638,372,98010,52.99
2087,92,RASHMI SHARDA PRASAD SHRIVASTAVA,Adarshwaadi Congress Party,1062,1,1063,0.57
2088,92,RAM MILAN VISHWAKARMA,Samajwadi Party,1532,6,1538,0.83
2089,92,RAMLALA SINGH YADAV,Pichhara Samaj Party United,207,0,207,0.11
2090,92,LAIQUE AHMAD QURESHI,Gondvana Gantantra Party,3180,12,3192,1.73
2091,92,SHIV NARAYAN SONI,Janata Dal (United),176,1,177,0.1
2092,92,HARKESH KUMAR CHOUDHARY PATRAKAAR,Bahujan Mukti Party,224,5,229,0.12
2093,92,RISHI KUMAR,Independent,438,4,442,0.24
2094,92,NARENDRA KUMAR,Independent,247,0,247,0.13
2095,92,NEERAJ SINGH BAGHEL,Independent,370,4,374,0.2
2096,92,RAJKUMAR,Independent,588,1,589,0.32
2097,92,RAM BHUWAN TRIPATHI,Independent,1816,1,1817,0.98
2098,92,NOTA,None of the Above,3395,3,3398,1.84
2099,2,DHARA SINGH KUSHWAH,Bahujan Samaj Party,34209,137,34346,16.58
2100,2,BABOO LAL MEWRA,Bharatiya Janata Party,51266,321,51587,24.91
2101,2,RAMNIWAS RAWAT,Indian National Congress,68818,828,69646,33.63
2102,2,RAMNIWASH KUSHWAH,Public Political Party,1083,1,1084,0.52
2103,2,DEEPAK KHATIK,Independent,242,0,242,0.12
2104,2,DURJAN JATAV,Independent,595,0,595,0.29
2105,2,BABU LAL,Independent,821,0,821,0.4
2106,2,MUKESH MALHOTRA AD.,Independent,44043,85,44128,21.31
2107,2,RAMPAL ADIWASI,Independent,932,0,932,0.45
2108,2,RAMROOP SINGH,Independent,430,2,432,0.21
2109,2,LAKHAN SINGH,Independent,709,0,709,0.34
2110,2,SULTAN,Independent,685,0,685,0.33
2111,2,NOTA,None of the Above,1892,3,1895,0.92
2112,144,DWARKA PRASAD DHAKAD (Advocate),Bahujan Samaj Party,1148,22,1170,0.66
2113,144,MUKESH TANDAN,Bharatiya Janata Party,98460,786,99246,56.31
2114,144,SHASHANK SHRI KRISHAN BHARGAVA,Indian National Congress,70788,1648,72436,41.1
2115,144,SANJAY PRABHAKAR,Rashtriya Pratibha Party,663,1,664,0.38
2116,144,KANCHHEDI-LAL,Independent,113,1,114,0.06
2117,144,DILEEP KUSHWAH,Independent,106,1,107,0.06
2118,144,MOKAM SINGH PANTHI,Independent,115,1,116,0.07
2119,144,RAM DAYAL KORI,Independent,269,2,271,0.15
2120,144,SATYENDRA SINGH SISODIYA,Independent,405,0,405,0.23
2121,144,SANJAY SAINI,Independent,396,2,398,0.23
2122,144,NOTA,None of the Above,1288,35,1323,0.75
2123,216,ANIL JAIN KALUHEDA,Bharatiya Janata Party,92876,659,93535,57.71
2124,216,ABDUL RAJJAK LALA,Bahujan Samaj Party,571,7,578,0.36
2125,216,SMT. MAYA RAJESH TRIVEDI,Indian National Congress,65309,713,66022,40.74
2126,216,HAJI MUSHTAK AHMED,Independent,398,2,400,0.25
2127,216,MOHAMMAD RAFIQUE,Independent,204,1,205,0.13
2128,216,SURESH PRAJAPAT,Independent,133,4,137,0.08
2129,216,NOTA,None of the Above,1175,19,1194,0.74
2130,217,CHETAN PREMNARAYAN YADAV,Indian National Congress,81467,1291,82758,45.04
2131,217,PRAKASH NARVARIYA,Bahujan Samaj Party,1394,25,1419,0.77
2132,217,DR. MOHAN YADAV,Bharatiya Janata Party,94753,946,95699,52.08
2133,217,KULDEEP SINGH RATHOD,Vastavik Bharat Party,549,5,554,0.3
2134,217,NILESH TIWARI,Independent,171,2,173,0.09
2135,217,PREM SINGH,Independent,351,4,355,0.19
2136,217,RAHUL CHOUHAN,Independent,142,0,142,0.08
2137,217,VIRENDRA SINGH ATAL,Independent,289,3,292,0.16
2138,217,SANDEEP PATEL,Independent,246,2,248,0.13
2139,217,NOTA,None of the Above,2067,31,2098,1.14
2140,140,KADHORI LAL AHIRAWAR,Bahujan Samaj Party,1795,5,1800,0.84
2141,140,DEVENDRA SINGH PATEL,Indian National Congress,80272,1184,81456,37.8
2142,140,NARENDRA SHIVAJI PATEL,Bharatiya Janata Party,123499,780,124279,57.67
2143,140,BABULAL CHOUDHRI PHALBAN,Aazad Samaj Party (Kanshi Ram),3115,5,3120,1.45
2144,140,VINOD SINGH,Jai Prakash Janata Dal,666,6,672,0.31
2145,140,NARENDRA SINGH PATEL,Independent,1218,3,1221,0.57
2146,140,MAHENDRA KUMAR DHAKAD,Independent,908,0,908,0.42
2147,140,NOTA,None of the Above,2023,9,2032,0.94
2148,134,ABHIJEET SHAH (ANKIT BABA),Indian National Congress,75924,630,76554,47.41
2149,134,"SANJAY SHAH ""MAKDAI""",Bharatiya Janata Party,75219,385,75604,46.82
2150,134,NANDKISHOR BETHE,Gondvana Gantantra Party,1155,4,1159,0.72
2151,134,Bhaulal Uikey,Gana Suraksha Party,441,3,444,0.27
2152,134,JAY KUMAR UIKEY,Independent,755,2,757,0.47
2153,134,RAMESH MASKOLE,Independent,3501,61,3562,2.21
2154,134,LAKSHMAN DHURVEY,Independent,837,0,837,0.52
2155,134,NOTA,None of the Above,2547,14,2561,1.59
2156,43,YADVENDRA SINGH (JAGGU BHAIYA),Indian National Congress,82364,1033,83397,46.87
2157,43,RAKESH GIRI,Bharatiya Janata Party,73986,293,74279,41.75
2158,43,SEETARAM LODHI,Bahujan Samaj Party,1881,13,1894,1.06
2159,43,ABHISHEK JAIN,Indian Peoples Adhikar Party,218,1,219,0.12
2160,43,ANAND KUSHAWAHA,Jan Adhikar Party,1034,0,1034,0.58
2161,43,KAVITA SINGH PARIHAR,Aam Bhartiya Party,123,1,124,0.07
2162,43,RAKESH YADAV,Aazad Samaj Party (Kanshi Ram),320,0,320,0.18
2163,43,RAMBAGAS LODHI,Bharatiya Sabhyata Party,106,0,106,0.06
2164,43,SANJAY YADAV (SHEELU),Samajwadi Party,1272,8,1280,0.72
2165,43,K.K. SHRIVASTAVA,Independent,8535,137,8672,4.87
2166,43,GHANSHYAM AHIRWAR,Independent,224,0,224,0.13
2167,43,GHANSHYAM LODHI,Independent,243,0,243,0.14
2168,43,DEEPCHAND PRAJAPATI,Independent,407,0,407,0.23
2169,43,BABULAL YADAV,Independent,553,0,553,0.31
2170,43,MEENA DEVI KUMHAR,Independent,602,0,602,0.34
2171,43,RAJU RAIKWAR,Independent,1191,0,1191,0.67
2172,43,RAMCHARAN AHIRWAR,Independent,849,0,849,0.48
2173,43,VIJAY KUMAR,Independent,574,0,574,0.32
2174,43,SUKA AHIRWAR,Independent,105,0,105,0.06
2175,43,SURENDRA JAIN,Independent,99,0,99,0.06
2176,43,SANJAY KUMAR AHIRWAR,Independent,1054,1,1055,0.59
2177,43,HARIRAM CHADHAAR,Independent,229,0,229,0.13
2178,43,NOTA,None of the Above,456,10,466,0.26
2179,194,ELIYAS BHai MACHAR,Bahujan Samaj Party,2395,1,2396,1.04
2180,194,KALSINGH BHABAR,Bharatiya Janata Party,103352,505,103857,44.87
2181,194,VEERSINGH BHURIYA,Indian National Congress,104349,848,105197,45.45
2182,194,TOLSINGH BHURIYA,Janata Dal (United),3098,5,3103,1.34
2183,194,MANISH BhAI MUNIYA CHAPANER,Bhartiya Tribal Party,547,1,548,0.24
2184,194,MAJU DAMOR,Bharat Adivasi Party,9171,44,9215,3.98
2185,194,UDAYSINGH MASSAR,Independent,764,3,767,0.33
2186,194,TANSINGH MAIDA,Independent,1643,10,1653,0.71
2187,194,BABU DAMOR,Independent,1623,1,1624,0.7
2188,194,NOTA,None of the Above,3104,4,3108,1.34
2189,70,DEVENDRA SINGH,Bahujan Samaj Party,24267,126,24393,16.37
2190,70,MAHARSHI SINGH,Aam Aadmi Party,661,5,666,0.45
2191,70,RAMA SHANKAR SINGH,Indian National Congress,55673,663,56336,37.8
2192,70,SIDDHARTH TIWARI 'RAJ',Bharatiya Janata Party,60554,528,61082,40.99
2193,70,COMMANDO ARUN GAUTAM (EX-ARMY),Vindhya Janta Party,1781,10,1791,1.2
2194,70,KAMALDHARI KUSHWAHA,Bhartiya Shakti Chetna Party,324,2,326,0.22
2195,70,TRINETRA SHUKLA,Samajwadi Party,551,0,551,0.37
2196,70,RAMLAL KOL,Jan Adhikar Party,172,0,172,0.12
2197,70,SANGEETA KOL,Peoples Party of India (Democratic),209,4,213,0.14
2198,70,ENGINEER PUSHPRAJ PAL,Independent,608,1,609,0.41
2199,70,RAMKALI,Independent,651,2,653,0.44
2200,70,SHIROMAN KUSHWAHA,Independent,636,0,636,0.43
2201,70,HARI SHANKER,Independent,449,0,449,0.3
2202,70,NOTA,None of the Above,1147,1,1148,0.77
2203,120,RAMA ASHOK BHAI KUSHWAHA,Bahujan Samaj Party,1540,3,1543,0.95
2204,120,"VISHWANATH SINGH ""MULAM BHAIYA""",Bharatiya Janata Party,83584,332,83916,51.61
2205,120,"SANJAY SHARMA ""SANJU BHAIYA''",Indian National Congress,70854,715,71569,44.02
2206,120,KISHOR BHANU SHAH (BABUJI),Independent,1377,4,1381,0.85
2207,120,PRAMOD THAKUR,Independent,1484,2,1486,0.91
2208,120,"VISHVANATH SINGH "" MUNNA BHAIYA""'",Independent,1311,1,1312,0.81
2209,120,NOTA,None of the Above,1381,8,1389,0.85
2210,214,JAGDISH CHOUHAN,Bahujan Samaj Party,1737,1,1738,1.13
2211,214,TARACHAND GOYAL,Bharatiya Janata Party,73081,555,73636,47.83
2212,214,MAHESH PARMAR,Indian National Congress,75030,789,75819,49.25
2213,214,MAHESH PARMAR,Independent,1256,3,1259,0.82
2214,214,RAMCHANDRA RATHOR,Independent,587,1,588,0.38
2215,214,NOTA,None of the Above,910,3,913,0.59
2216,226,Dung Hardeepsingh,Bharatiya Janata Party,123504,791,124295,53.06
2217,226,Balwant Singh Gurjar,Bahujan Samaj Party,1688,10,1698,0.72
2218,226,RAKESH PATIDAR,Indian National Congress,100352,1274,101626,43.38
2219,226,PRINCE SURYAWANSHI,Aazad Samaj Party (Kanshi Ram),2798,7,2805,1.2
2220,226,Govrdhan Lal HADA,Independent,269,2,271,0.12
2221,226,Naharu,Independent,199,15,214,0.09
2222,226,FIROJUDDIN,Independent,241,2,243,0.1
2223,226,Rakesh,Independent,810,7,817,0.35
2224,226,Shaheed Khan,Independent,465,3,468,0.2
2225,226,NOTA,None of the Above,1835,3,1838,0.78
2226,165,NAVEEN MISHRA,Bahujan Samaj Party,2825,13,2838,1.4
2227,165,"BHAIRON SINGH "" BAPU """,Indian National Congress,96617,967,97584,48.27
2228,165,"VIKRAM SINGH RANA ""GUDDU BHAIYA""",Bharatiya Janata Party,84511,428,84939,42.02
2229,165,JITU PATIDAR,Independent,12535,97,12632,6.25
2230,165,MOHSIN - BHANEJ,Independent,341,1,342,0.17
2231,165,RAMESHWAR MANDLOI,Independent,912,3,915,0.45
2232,165,VIKRAM SINGH ( RANA ),Independent,694,3,697,0.34
2233,165,SANTOSH JOSHI,Independent,881,5,886,0.44
2234,165,NOTA,None of the Above,1315,6,1321,0.65
2235,37,ANITA SATNAM DANGI,Bahujan Samaj Party,1202,5,1207,0.7
2236,37,GOVIND SINGH RAJPUT,Bharatiya Janata Party,83172,379,83551,48.73
2237,37,NEERAJ SHARMA,Indian National Congress,80917,456,81373,47.46
2238,37,TULSIRAM PAL (HINNOD),Bhartiya Shakti Chetna Party,1454,0,1454,0.85
2239,37,Raghunath Patel,Jan Adhikar Party,223,0,223,0.13
2240,37,ASHISH SEN,Independent,118,0,118,0.07
2241,37,JAKIR ALI,Independent,106,0,106,0.06
2242,37,NEERAJ SHARMA,Independent,141,2,143,0.08
2243,37,Er. YOGESH SINGH KUSHWAHA,Independent,521,3,524,0.31
2244,37,VINOD KURMI,Independent,349,0,349,0.2
2245,37,SHISHUPAL SINGH,Independent,573,1,574,0.33
2246,37,SAIFUDDIN,Independent,753,2,755,0.44
2247,37,NOTA,None of the Above,1077,2,1079,0.63
2248,5,AJAB SINGH KUSHWAH,Indian National Congress,54754,535,55289,29.7
2249,5,AIDAL SINGH KANSANA,Bharatiya Janata Party,72134,374,72508,38.95
2250,5,KULDEEP SINGH SIKARWAR,Bahujan Samaj Party,56197,303,56500,30.35
2251,5,Smt MAMTA KUSHWAH,Aazad Samaj Party (Kanshi Ram),623,1,624,0.34
2252,5,SIYARAM,Independent,87,1,88,0.05
2253,5,SUSHEL KUMAR KUSHWAH,Independent,82,0,82,0.04
2254,5,HOTAM SINGH PARMAR,Independent,232,0,232,0.12
2255,5,SHRINIWAS,Independent,252,2,254,0.14
2256,5,NOTA,None of the Above,557,5,562,0.3
2257,170,BABULAL CHOUHAN,Bahujan Samaj Party,1907,7,1914,0.95
2258,170,Dr. RAJESH SONKAR,Bharatiya Janata Party,108168,701,108869,54.21
2259,170,SAJJAN SINGH VERMA,Indian National Congress,82563,869,83432,41.54
2260,170,KAILASH KALESHRIA,Aazad Samaj Party (Kanshi Ram),3391,10,3401,1.69
2261,170,DARIYAV SINGH MALVIYA,Independent,383,2,385,0.19
2262,170,PARHLADSINGH,Independent,185,0,185,0.09
2263,170,RAKESH SONKAR,Independent,228,5,233,0.12
2264,170,RAJENDER VERMA,Independent,442,6,448,0.22
2265,170,RAJESH SONKAR,Independent,705,3,708,0.35
2266,170,NOTA,None of the Above,1256,6,1262,0.63
2267,138,PUSHPRAJ SINGH,Indian National Congress,100924,693,101617,48.05
2268,138,VIJAYPAL SINGH,Bharatiya Janata Party,102894,485,103379,48.89
2269,138,HARISINGH KALME,Mahakaushal Rashtriya Party,1598,7,1605,0.76
2270,138,UMESH KUMAR MITTAL,Independent,900,9,909,0.43
2271,138,RAMESHWAR AHIRWAR,Independent,436,5,441,0.21
2272,138,LAXMAN SINGH GOUR,Independent,1149,3,1152,0.54
2273,138,NOTA,None of the Above,2355,7,2362,1.12
2274,147,ISEM SINGH MORYE,Aam Aadmi Party,1797,2,1799,1.01
2275,147,UMAKANT SHARMA,Bharatiya Janata Party,97709,286,97995,54.83
2276,147,GAGNENDRA SINGH RAGHUWANSHI,Indian National Congress,69935,378,70313,39.34
2277,147,TOSHMANI PANTHI (KANNA),Bahujan Samaj Party,1415,9,1424,0.8
2278,147,AKHILESH JAIN (MURARIA),Sapaks Party,171,2,173,0.1
2279,147,ASLAM GOURI,Samajwadi Party,489,0,489,0.27
2280,147,KAPTAN SINGH,National World Leader Party,330,0,330,0.18
2281,147,GABBAR SINGH AHIRWAR,Aazad Samaj Party (Kanshi Ram),2233,1,2234,1.25
2282,147,POORAN SINGH AHIRWAR,Independent,184,0,184,0.1
2283,147,PHOOL SINGH,Independent,249,0,249,0.14
2284,147,MANOJ KUSHWAH,Independent,395,0,395,0.22
2285,147,LAXMINARAYAN KUSHWAH,Independent,360,0,360,0.2
2286,147,SANDEEP AHIRWAR,Independent,802,0,802,0.45
2287,147,HEMANT SINGH KUSHWAHA,Independent,836,1,837,0.47
2288,147,NOTA,None of the Above,1130,6,1136,0.64
2289,68,KANTI KUMAR DUBEY,Communist Party of India (Marxist),1664,24,1688,1.18
2290,68,DIVYARAJ SINGH,Bharatiya Janata Party,54577,298,54875,38.42
2291,68,RAMGARIB VANVASI,Indian National Congress,34883,677,35560,24.9
2292,68,V. D. PANDEY,Bahujan Samaj Party,40676,409,41085,28.77
2293,68,SARITA PANDEY,Aam Aadmi Party,866,8,874,0.61
2294,68,Er. AVINASH SHUKLA,Rashtravadi Bharat Party,1364,15,1379,0.97
2295,68,DEVENDRA KUMAR SHUKLA,Bhartiya Shakti Chetna Party,276,3,279,0.2
2296,68,MANOJ SINGH BAGHEL,Vindhya Janta Party,416,2,418,0.29
2297,68,ADVOCATE. ROHINI PRASAD KUSHWAHA,Peoples Party of India (Democratic),369,1,370,0.26
2298,68,LAXMAN TIWARI,Samajwadi Party,2053,12,2065,1.45
2299,68,SHIVKUMAR KUSHWAHA,Jan Adhikar Party,375,1,376,0.26
2300,68,SHIV PRASAD SAHU,Bahujan Mukti Party,1097,3,1100,0.77
2301,68,CHHEDILAL KOL (RAWAT),Independent,845,3,848,0.59
2302,68,LALMANI KUSHWAHA,Independent,978,3,981,0.69
2303,68,NOTA,None of the Above,917,3,920,0.64
2304,80,CHANDRA PRATAP VISHWAKARMA(CHANDE),Bahujan Samaj Party,29565,108,29673,18.65
2305,80,Rani Agrawal,Aam Aadmi Party,8075,110,8185,5.14
2306,80,RAM NIWAS SHAH,Bharatiya Janata Party,74355,314,74669,46.93
2307,80,Renu Shah,Indian National Congress,36121,571,36692,23.06
2308,80,AJIMULLA,Aazad Samaj Party (Kanshi Ram),726,0,726,0.46
2309,80,ASHWANI KUMAR SHAH MOOLNIWASI,Peoples Party of India (Democratic),232,2,234,0.15
2310,80,OMP RAKASH SINGH,Samajwadi Party,596,4,600,0.38
2311,80,KUNDAN PANDEY,Vindhya Janta Party,1331,10,1341,0.84
2312,80,CHATURGUN PAL,Bhartiya Shakti Chetna Party,537,2,539,0.34
2313,80,PINTU LAL KUSHWAHA,Jan Adhikar Party,671,4,675,0.42
2314,80,MAHESH PRATAP SINGH,Communist Party of India,1384,2,1386,0.87
2315,80,RAMESHWAR PANDEY ADHIWAKTA,Saman Aadmi Saman Party,524,0,524,0.33
2316,80,ATUL KUMAR DUBEY MEDIA,Independent,941,3,944,0.59
2317,80,PUSHPENDRA GUPTA,Independent,1023,1,1024,0.64
2318,80,MADHVENDRA SHUKLA,Independent,444,0,444,0.28
2319,80,NOTA,None of the Above,1440,9,1449,0.91
2320,143,DEVENDRA PATEL,Indian National Congress,94961,974,95935,51.39
2321,143,RAMPAL SINGH,Bharatiya Janata Party,83992,489,84481,45.26
2322,143,MOHD TALAT KHAN,Aazad Samaj Party (Kanshi Ram),1926,3,1929,1.03
2323,143,NARENDRA SINGH,Gondvana Gantantra Party,650,1,651,0.35
2324,143,DEVENDRA,Independent,308,0,308,0.16
2325,143,THAKUR-PRADEEP-SINGH,Independent,256,0,256,0.14
2326,143,MANOJ,Independent,368,0,368,0.2
2327,143,MUEEN UDDIN,Independent,718,0,718,0.38
2328,143,NOTA,None of the Above,2015,7,2022,1.08
2329,102,EKTA THAKUR,Indian National Congress,58160,845,59005,32.51
2330,102,ENGINEER SUBHASH SINGH MARKAM,Bahujan Samaj Party,11050,51,11101,6.12
2331,102,SANTOSH VARKADE,Bharatiya Janata Party,101337,440,101777,56.07
2332,102,SHIV PRASAD DHURVE,Bhartiya Shakti Chetna Party,2207,6,2213,1.22
2333,102,MOHAN SONDHIYA,Independent,1485,3,1488,0.82
2334,102,DR. SANJIV WARKHEDE,Independent,2900,6,2906,1.6
2335,102,NOTA,None of the Above,3020,13,3033,1.67
2336,78,KAMLESHWAR INDRAJEET KUMAR,Indian National Congress,69930,677,70607,40.01
2337,78,VISHWAMITRA PATHAK,Bharatiya Janata Party,86613,472,87085,49.35
2338,78,SANKALAN KOL (RANI VERMA),Bahujan Samaj Party,9265,27,9292,5.27
2339,78,GIRIJA PRASAD KEWAT,Rashtriya mahan Gantantra Party,667,0,667,0.38
2340,78,"""MOOLNIWASI"" BIRBAHADUR CHHATHILAL SINGH TEKAM",Peoples Party of India (Democratic),361,4,365,0.21
2341,78,BHAGIRATH SINGH BADKADE,Aazad Samaj Party (Kanshi Ram),622,1,623,0.35
2342,78,BHARAT BHAI PATEL,Bhartiya Shakti Chetna Party,1309,1,1310,0.74
2343,78,RAJKUMAR KUSHWAHA,Jan Adhikar Party,680,2,682,0.39
2344,78,BHAGWAN DAS (B.D.SAHU),Independent,2138,2,2140,1.21
2345,78,MARKANDE PRASAD RAWAT,Independent,1516,0,1516,0.86
2346,78,NOTA,None of the Above,2174,2,2176,1.23
2347,77,Anand Mangal Singh,Aam Aadmi Party,2721,14,2735,1.55
2348,77,Bhai Ramkhelavan Rajak Urf Khilari Dhobi,Bahujan Samaj Party,3306,8,3314,1.87
2349,77,Riti Pathak,Bharatiya Janata Party,88469,195,88664,50.12
2350,77,Gyan Singh,Indian National Congress,52792,454,53246,30.1
2351,77,Adesh Kumar Jayswal (Afsar Bhai),Jan Adhikar Party,1235,0,1235,0.7
2352,77,Moolnivasi Geeta Rajkumar Sahu,Peoples Party of India (Democratic),577,3,580,0.33
2353,77,Daddu Lal Pandey,Bhartiya Shakti Chetna Party,881,3,884,0.5
2354,77,Balmeek Prasad Tripathi,Vindhya Janta Party,568,2,570,0.32
2355,77,Ram Kumar Gupta (Bade),Jan Sewa Driver Party,687,0,687,0.39
2356,77,Rampratap Singh Yadav,Samajwadi Party,4994,14,5008,2.83
2357,77,Lal Bahadur Singh Uike,Aazad Samaj Party (Kanshi Ram),1592,3,1595,0.9
2358,77,Shailendra Tiwari (Shailu Dutt),Rashtravadi Bharat Party,636,1,637,0.36
2359,77,Sudama Kol,Aadim Samaj Party,1122,0,1122,0.63
2360,77,Kedar Nath Shukla,Independent,13739,117,13856,7.83
2361,77,Bhole Prasad Yadav,Independent,606,0,606,0.34
2362,77,Manfer Singh,Independent,1184,0,1184,0.67
2363,77,Rinkoo Kushwaha,Independent,341,0,341,0.19
2364,77,NOTA,None of the Above,651,3,654,0.37
2365,168,Inder Singh Parmar,Bharatiya Janata Party,95512,542,96054,51.84
2366,168,Kavi Manohar Bouddh,Bahujan Samaj Party,1110,3,1113,0.6
2367,168,Ramveer Singh Sikarwar,Indian National Congress,81799,595,82394,44.46
2368,168,Kailasha Choodiya,Aazad Samaj Party (Kanshi Ram),2866,7,2873,1.55
2369,168,Babulal Malviya Khedinagar,Samajwadi Party,244,3,247,0.13
2370,168,Indar Singh Parmar,Independent,149,5,154,0.08
2371,168,Ibrahim Beg,Independent,463,2,465,0.25
2372,168,Jogendra Singh Parmar,Independent,465,1,466,0.25
2373,168,Dr. Qazi. S. Rehman (Saeed. Bhai),Independent,264,1,265,0.14
2374,168,NOTA,None of the Above,1264,6,1270,0.69
2375,25,ABRAN SINGH (KALLI) GURJAR,Bahujan Samaj Party,10656,47,10703,5.41
2376,25,DEVENDRA KUMAR JAIN 'PATTE WALE',Bharatiya Janata Party,111495,829,112324,56.74
2377,25,K. P. SINGH 'KAKKA JOO',Indian National Congress,68286,1008,69294,35.01
2378,25,PARMA RATHORE,Parivartan Party of India,870,1,871,0.44
2379,25,RADHE SHYAM SHARMA,Rashtra Nirman Party,247,1,248,0.13
2380,25,SATENDAR KARAIYA,Aazad Samaj Party (Kanshi Ram),548,0,548,0.28
2381,25,AMAN SONI,Independent,182,1,183,0.09
2382,25,MANOJ SURYAVANSHI (SAMMELAN AYOJAK),Independent,676,0,676,0.34
2383,25,YASHAVANT SINGH YADAV CHANDAVANI,Independent,264,1,265,0.13
2384,25,RAMESH SHARMA,Independent,332,3,335,0.17
2385,25,VIJAY BATHAM,Independent,537,2,539,0.27
2386,25,HAJARI LAL KOTIA (RATHORE),Independent,576,1,577,0.29
2387,25,NOTA,None of the Above,1381,8,1389,0.7
2388,1,DURGALAL VIJAY (VAKEEL SAAB),Bharatiya Janata Party,85006,708,85714,40.45
2389,1,BABU JANDEL,Indian National Congress,95602,1242,96844,45.7
2390,1,BIHARI SINGH SOLANKI,Bahujan Samaj Party,22833,221,23054,10.88
2391,1,ADIL KHAN,Social Democratic Party Of India,729,4,733,0.35
2392,1,YOGESH TYAGI,Rashtriya Krantikari Samajwadi Party,233,1,234,0.11
2393,1,SHIV MAHESH MODI JI,Parivartan Party of India,166,1,167,0.08
2394,1,HARiSHAKAR JATAV,Aazad Samaj Party (Kanshi Ram),378,8,386,0.18
2395,1,AYYUB QURESHI,Independent,216,0,216,0.1
2396,1,TEJPAL AADiVASHi,Independent,206,3,209,0.1
2397,1,Smt. DURGESH NANDNI,Independent,304,1,305,0.14
2398,1,BALWAN,Independent,724,0,724,0.34
2399,1,MURLIDHAR PRAJAPATI,Independent,482,0,482,0.23
2400,1,RAJENDRA KUMAR SHRIVASTAV,Independent,406,0,406,0.19
2401,1,HARViLASH,Independent,634,0,634,0.3
2402,1,NOTA,None of the Above,1794,7,1801,0.85
2403,148,MAHARAJ SINGH DIWAKAR,Bahujan Samaj Party,1451,6,1457,0.9
2404,148,SINDHU VIKRAM SINGH (BHANWAR BANA),Indian National Congress,67435,535,67970,41.87
2405,148,SURYA PRAKASH MEENA,Bharatiya Janata Party,86859,375,87234,53.74
2406,148,KASHIRAM RAGHUWANSHI,Akhil Bhartiya Aarakshit Samaj Party,990,0,990,0.61
2407,148,PRADEEP RATHOR,Indian Peoples Adhikar Party,174,0,174,0.11
2408,148,MAKHAN SINGH AHIRWAR,Aazad Samaj Party (Kanshi Ram),1424,1,1425,0.88
2409,148,RAJKUMARI MANJHI (KEVAT),Jan Adhikar Party,255,0,255,0.16
2410,148,SHISHUPAL YADAV,Samajwadi Party,311,1,312,0.19
2411,148,AKARAM BHAI,Independent,361,1,362,0.22
2412,148,JASWANT SINGH MEENA,Independent,445,1,446,0.27
2413,148,RAHUL RAJ (KISAN NETA),Independent,624,0,624,0.38
2414,148,NOTA,None of the Above,1068,1,1069,0.66
2415,167,ARUN BHIMAWAD,Bharatiya Janata Party,98184,776,98960,47.33
2416,167,KARADA HUKUMSINGH,Indian National Congress,98034,898,98932,47.32
2417,167,BHAGIRATH BAGAANIYA,Bahujan Samaj Party,1401,10,1411,0.67
2418,167,KANTILAL,Aazad Samaj Party (Kanshi Ram),5675,14,5689,2.72
2419,167,AMIT JATAV,Independent,217,2,219,0.1
2420,167,OMPRAKASH VERMA,Independent,344,2,346,0.17
2421,167,RAM SWROOP SHARMA,Independent,226,3,229,0.11
2422,167,SUNIL,Independent,887,10,897,0.43
2423,167,HARI SINGH THAKUR (GOHIL),Independent,865,5,870,0.42
2424,167,NOTA,None of the Above,1516,18,1534,0.73
2425,103,AMAR SINGH MARKO,Aam Aadmi Party,4521,9,4530,2.04
2426,103,OMPRAKASH DHURWEY,Bharatiya Janata Party,84487,357,84844,38.23
2427,103,BHOOPENDRA MARAVI (BABLU),Indian National Congress,78227,1000,79227,35.7
2428,103,AMAN SINGH PORTE,Gondvana Gantantra Party,40718,142,40860,18.41
2429,103,RAMESH KUMAR BANWASI,Bhartiya Shakti Chetna Party,2841,3,2844,1.28
2430,103,SUKHDEV SINGH KUSHRAM,Aapki Apni Party (Peoples),3028,1,3029,1.36
2431,103,SANJU KUMAR MARAVI,Gana Suraksha Party,1954,0,1954,0.88
2432,103,NOTA,None of the Above,4624,12,4636,2.09
2433,20,GHANSHYAM SINGH,Indian National Congress,40597,679,41276,29.32
2434,20,DUBEY SANJAY,Aam Aadmi Party,7712,34,7746,5.5
2435,20,PRADEEP AGRAWAL,Bharatiya Janata Party,43586,248,43834,31.14
2436,20,LAKHAN SINGH YADAV,Bahujan Samaj Party,12712,75,12787,9.08
2437,20,ALOK SINGH JADOUN,Aam Bhartiya Party,307,0,307,0.22
2438,20,KARAN SiNGH KUSHWAH,National Youth Party,413,2,415,0.29
2439,20,DAMODAR SiNGH-YADAV,Aazad Samaj Party (Kanshi Ram),28960,82,29042,20.63
2440,20,DEVENDRASiNgh ChAuHAN,Samajwadi Party,515,0,515,0.37
2441,20,DHAN SINGH BAGHEL,Jan Adhikar Party,615,1,616,0.44
2442,20,Sobran Baghel,All India Forward Bloc,309,1,310,0.22
2443,20,KALYAN JATAV (HARSHVARDHAN SINGH),Independent,196,0,196,0.14
2444,20,JASVANT SiNGH,Independent,389,0,389,0.28
2445,20,MAHiPAT SiNGH,Independent,351,0,351,0.25
2446,20,MEENA KUSHWAHA,Independent,400,0,400,0.28
2447,20,RAJESH SINGH,Independent,389,0,389,0.28
2448,20,RAM AVTAR Singh KuShWAH,Independent,878,0,878,0.62
2449,20,RAM KUMAR EToRIYA,Independent,517,0,517,0.37
2450,20,VAIDHYA RAMKUMAR GUPTA URF VIDHAYAKJI,Independent,175,1,176,0.13
2451,20,RAMPRAKASH,Independent,331,0,331,0.24
2452,20,NOTA,None of the Above,289,4,293,0.21
2453,136,AJAY BALRAM SINGH PATEL,Indian National Congress,67387,481,67868,32.65
2454,136,PREMSHANKAR KUNJILAL VERMA,Bharatiya Janata Party,103288,594,103882,49.98
2455,136,SUNIL GOUR,Aam Aadmi Party,4523,42,4565,2.2
2456,136,UMED SINGH JAT,Gondvana Gantantra Party,3800,29,3829,1.84
2457,136,DEVRAJ KAROCHE,Bahujan Mukti Party,263,3,266,0.13
2458,136,DHEERAJ CHOUHAN,Indian Peoples Adhikar Party,329,4,333,0.16
2459,136,NARENDRA RAGHUWANSHI PATRAKAR,Rashtravadi Bharat Party,551,1,552,0.27
2460,136,FAGRAM,Samajwadi Jan Parishad,1377,15,1392,0.67
2461,136,MANGILAL MANIK GOLGAON,Akhand Bharat Samrajya Party,292,2,294,0.14
2462,136,AJAY PATEL,Independent,488,15,503,0.24
2463,136,"""OM BHAIYA"" OMPRAKASH HAJARILAL RAGHUWANSHI",Independent,18704,156,18860,9.07
2464,136,ENGINEER KAILASHSINGH DHURVEY,Independent,644,11,655,0.32
2465,136,YOGESH KUMAR SAHU,Independent,389,1,390,0.19
2466,136,RAM MOHAN GOUR JI PATEL,Independent,561,1,562,0.27
2467,136,SURESH UIKEY URF DUGGI,Independent,1610,7,1617,0.78
2468,136,NOTA,None of the Above,2295,3,2298,1.11
2469,115,ANAND PANJWANI,Indian National Congress,96786,1591,98377,42.14
2470,115,DINESH RAI MUNMUN,Bharatiya Janata Party,115915,880,116795,50.03
2471,115,ANKIT SINGH BAGHEL,Rashtriya Gondvana Party,1015,5,1020,0.44
2472,115,"RANJEET RAMDAS WASNIK ""DAU""",Gondvana Gantantra Party,10329,66,10395,4.45
2473,115,SHABANA (SONA) KHAN,Navodaya Jantantrik Party,255,3,258,0.11
2474,115,AJAY OMKAR SINGH BAGHEL,Independent,343,2,345,0.15
2475,115,TILAK SINGH JATAV,Independent,248,0,248,0.11
2476,115,TEERATH SINGH CHANDEL,Independent,182,1,183,0.08
2477,115,MAKBUL SHAH,Independent,459,0,459,0.2
2478,115,MUNUWAR KHAN,Independent,608,0,608,0.26
2479,115,LATA,Independent,632,2,634,0.27
2480,115,MOHAD. SHADAB PATEL,Independent,1440,0,1440,0.62
2481,115,NOTA,None of the Above,2684,19,2703,1.16
2482,187,ANTAR SINGH ARYA,Bharatiya Janata Party,103975,484,104459,47.51
2483,187,Er.Nansing Nawde,Aam Aadmi Party,4135,20,4155,1.89
2484,187,MONTU SOLANKI,Indian National Congress,105347,789,106136,48.28
2485,187,NOTA,None of the Above,5087,11,5098,2.32
2486,69,ABHAY MISHRA,Indian National Congress,55536,488,56024,34.92
2487,69,K. P. TRIPATHI,Bharatiya Janata Party,55181,206,55387,34.53
2488,69,PANKAJ SINGH,Bahujan Samaj Party,43992,166,44158,27.53
2489,69,NAGENDRA SINGH,Bhartiya Shakti Chetna Party,513,2,515,0.32
2490,69,NAGENDR SINGH KARCHULI,All India Forward Bloc,153,0,153,0.1
2491,69,UMESH KOL,Independent,179,1,180,0.11
2492,69,KAMALBHAN SINGH,Independent,108,1,109,0.07
2493,69,TIRATH PRASAD KOL,Independent,91,0,91,0.06
2494,69,DIWAKAR PRASAD DWIVEDI (EX-ARMY),Independent,268,5,273,0.17
2495,69,DR. RAJNEESH PRAJAPATI,Independent,184,5,189,0.12
2496,69,RAKESH PRASAD PANDEY,Independent,194,0,194,0.12
2497,69,SANTOSH SHRIDHAR UPADHYAY,Independent,200,0,200,0.12
2498,69,SUDHEER KUMAR SAKET,Independent,248,0,248,0.15
2499,69,HAFIZ MOHAMMAD ALI,Independent,682,0,682,0.43
2500,69,SHRIDHAR DUBEY,Independent,946,0,946,0.59
2501,69,NOTA,None of the Above,1062,7,1069,0.67
2502,159,KAMLESH DOHARE,Bahujan Samaj Party,4027,76,4103,2.26
2503,159,SHASHANK RAMESH SAXENA,Indian National Congress,67381,765,68146,37.55
2504,159,SUDESH RAI,Bharatiya Janata Party,104978,1019,105997,58.4
2505,159,ANUPAMA TIWARI,Rashtriya Navjagran Party,1007,0,1007,0.55
2506,159,MOHAMMAD AKRAM QURESHI,Independent,242,1,243,0.13
2507,159,Dr. AKRAM KHAN,Independent,779,0,779,0.43
2508,159,AAKASH,Independent,307,2,309,0.17
2509,159,NOTA,None of the Above,903,14,917,0.51
2510,125,NANABHAU MOHOD,Bharatiya Janata Party,80477,490,80967,43.72
2511,125,PANJABRAO SOMKUWAR,Bahujan Samaj Party,1744,18,1762,0.95
2512,125,VIJAY REVNATH CHORE,Indian National Congress,91477,1032,92509,49.95
2513,125,PRADIP BHAU JULAME,Aazad Samaj Party (Kanshi Ram),1082,6,1088,0.59
2514,125,FHOGAL BANSOD,Republican Party of India (A),149,0,149,0.08
2515,125,DR. MOHANLAL PUSE,Vanchit Bahujan Aaghadi,109,1,110,0.06
2516,125,SUNIL PAGARE,Bahujan Mukti Party,136,1,137,0.07
2517,125,ANIL BUDDHESHWAR GAJBHIYE,Independent,211,1,212,0.11
2518,125,ASHISH PARADKAR (PAWAR),Independent,381,4,385,0.21
2519,125,CHINDHESH SAHASTRABUDHDE,Independent,411,4,415,0.22
2520,125,DEVDAS PARTETI,Independent,743,7,750,0.4
2521,125,NAWAJ SHEIKH,Independent,411,0,411,0.22
2522,125,PRADEEP (BANDU) THAKARE (GURUJI),Independent,1475,9,1484,0.8
2523,125,BHAIYA-SHYAM SHIVHARE VAKIL,Independent,1343,1,1344,0.73
2524,125,SEVKRAM GAME,Independent,1038,8,1046,0.56
2525,125,NOTA,None of the Above,2418,4,2422,1.31
2526,63,GANESH SINGH,Bharatiya Janata Party,65999,598,66597,37.35
2527,63,DABBU SIDDHARTH SUKHLAL KUSHWAHA,Indian National Congress,69208,1430,70638,39.61
2528,63,SHIVA RATNAKAR CHATURBEDI,Bahujan Samaj Party,33132,435,33567,18.82
2529,63,CHANDA KUSHWAHA,Peoples Party of India (Democratic),322,5,327,0.18
2530,63,Jitendra Roy (Pourvancal Vale),Bharatiya Jan Morcha Party,178,2,180,0.1
2531,63,MUNNI KHAN ADVOCATE,Janata Congress,91,1,92,0.05
2532,63,HAJI MOIN KHAN,Samajwadi Party,176,1,177,0.1
2533,63,RAMKUSHAL KEVAT,Aapka Gantantra Party,268,2,270,0.15
2534,63,RANJANA MISHRA,Nyaydharmsabha,261,0,261,0.15
2535,63,HARI OM GUPTA,Vindhya Janta Party,1637,7,1644,0.92
2536,63,Harishankar Tiwari (Loha Wala),Sapaks Party,239,5,244,0.14
2537,63,AJAY DAHIYA (AJJU BHAIYA),Independent,152,1,153,0.09
2538,63,ANOOP PANDAY (BADKHAR),Independent,156,2,158,0.09
2539,63,MO. AMEEN (BHINGU BHAI),Independent,260,0,260,0.15
2540,63,ARUN KUMAR MISHRA URF PAPPU MISHRA,Independent,393,0,393,0.22
2541,63,AHAMAD KHAN,Independent,641,0,641,0.36
2542,63,GOPAL CHAUDHARI,Independent,521,1,522,0.29
2543,63,JAVED KHAN,Independent,353,0,353,0.2
2544,63,TRIBHUWAN PRASAD PANDEY TRIBHUWAN BHAI,Independent,221,0,221,0.12
2545,63,DEEPSHIKHA RAHUL SINGH,Independent,59,0,59,0.03
2546,63,NASREEN KHAN,Independent,43,1,44,0.02
2547,63,MANOJ KUMAR SHRIVASTAVA,Independent,54,0,54,0.03
2548,63,RAJ MOHAMMAD,Independent,63,0,63,0.04
2549,63,RAJIV KUMAR,Independent,129,0,129,0.07
2550,63,RAMMURTY PANDAY,Independent,83,0,83,0.05
2551,63,SHIV - VARAN - JEE BAGHA,Independent,71,1,72,0.04
2552,63,SUSHIL KUMAR,Independent,103,0,103,0.06
2553,63,DR. SANTOSH KUMAR SHARMA,Independent,132,2,134,0.08
2554,63,NOTA,None of the Above,874,14,888,0.5
2555,196,PRATAP GREWAL,Indian National Congress,85486,628,86114,49.35
2556,196,"WELSINGH BHURIYA """,Bharatiya Janata Party,81646,340,81986,46.98
2557,196,REVASHANKAR SINGAR,Bahujan Mukti Party,1340,2,1342,0.77
2558,196,RAJENDRA TOLARAM - GAMAD,Independent,2934,6,2940,1.68
2559,196,NOTA,None of the Above,2121,5,2126,1.22
2560,164,KALA-MAHESH MALVIYA,Indian National Congress,73447,594,74041,42.32
2561,164,GOTAM TETWAL,Bharatiya Janata Party,96557,538,97095,55.5
2562,164,DEV VERMA,Bahujan Samaj Party,1956,8,1964,1.12
2563,164,JAGDISH AHIRWAR,Samajwadi Party,334,3,337,0.19
2564,164,LAKHAN MANDAL,Independent,386,0,386,0.22
2565,164,NOTA,None of the Above,1117,10,1127,0.64
2566,211,TULSIRAM SILAWAT,Bharatiya Janata Party,149771,1277,151048,61.7
2567,211,REENA BOURASI DIDI,Indian National Congress,81250,944,82194,33.57
2568,211,SEEMA GOKUL GOYAL,Bahujan Samaj Party,1074,6,1080,0.44
2569,211,VINOD YADAV AMBEDKAR,Aazad Samaj Party (Kanshi Ram),7259,55,7314,2.99
2570,211,GHANSHYAM CHANDEL,Independent,308,0,308,0.13
2571,211,PREMCHAND WASIWAL (GUDDU),Independent,203,2,205,0.08
2572,211,BABU SIR,Independent,542,0,542,0.22
2573,211,NOTA,None of the Above,2104,15,2119,0.87
2574,142,DR. G. C. GAUTAM,Indian National Congress,77355,1332,78687,38.05
2575,142,DR. PRABHURAM CHOUDHARY,Bharatiya Janata Party,122000,960,122960,59.45
2576,142,SURAJ PAL SINGH (RETIRED TEACHER),Bahujan Samaj Party,1745,18,1763,0.85
2577,142,AMRAT BABU NARWARE ADVOCATE,Gana Suraksha Party,176,2,178,0.09
2578,142,UDAYBHAN SINGH,Bhartiya Gan Varta Party,216,1,217,0.1
2579,142,BHAI MUNSHILAL SILAWAT,Public Political Party,119,1,120,0.06
2580,142,RAJAN,Janata Congress,97,1,98,0.05
2581,142,GOVARDHAN JATAV,Independent,112,3,115,0.06
2582,142,CHARAN SINGH,Independent,122,4,126,0.06
2583,142,JAGAT SINGH,Independent,130,3,133,0.06
2584,142,BHEEKAM SINGH,Independent,237,2,239,0.12
2585,142,MANOJ AHIRWAR,Independent,571,2,573,0.28
2586,142,NOTA,None of the Above,1596,20,1616,0.78
2587,221,SHANKAR LAL,Bahujan Samaj Party,1650,1,1651,0.87
2588,221,SANGEETA-VIJAY CHAREL,Bharatiya Janata Party,41332,252,41584,21.81
2589,221,"HARSH VIJAY GEHLOT ""GUDDU""",Indian National Congress,65701,900,66601,34.93
2590,221,KAMLESHWAR DODIYAR,Bharat Adivasi Party,71036,183,71219,37.36
2591,221,DHARMENDRA,Janata Dal (United),1274,2,1276,0.67
2592,221,NAVEEN DAMOR ADVOCATE,Bhartiya Tribal Party,640,2,642,0.34
2593,221,BHURI SINGAD,Samajwadi Party,678,1,679,0.36
2594,221,PAVAN,Independent,1116,0,1116,0.59
2595,221,VAGESHWAR MAIDA,Independent,898,0,898,0.47
2596,221,SURAJ BHABHAR,Independent,2402,2,2404,1.26
2597,221,NOTA,None of the Above,2571,9,2580,1.35
2598,41,SMT. NIDHI SUNIL JAIN,Indian National Congress,58869,879,59748,42.27
2599,41,EN. MUKESH JAIN 'DHANA',Aam Aadmi Party,1618,30,1648,1.17
2600,41,SHALENDRA KUMAR JAIN,Bharatiya Janata Party,74213,556,74769,52.9
2601,41,ADVOCATE SMOHI JATAV,Bahujan Samaj Party,1227,13,1240,0.88
2602,41,NARENDRA SINGH SURYAWANSHI,Aazad Samaj Party (Kanshi Ram),591,1,592,0.42
2603,41,RAMLAL RAJAK,Bhartiya Shakti Chetna Party,110,3,113,0.08
2604,41,SMT. SONA PATEL,Socialist Unity Centre Of India (COMMUNIST),90,0,90,0.06
2605,41,ASLAM SIR,Independent,51,0,51,0.04
2606,41,ASLAM KHAN,Independent,77,0,77,0.05
2607,41,UMESH TRAHIMAM,Independent,208,6,214,0.15
2608,41,GOVARDHAN PATEL,Independent,117,2,119,0.08
2609,41,JAHID KHAN MANSURI,Independent,80,0,80,0.06
2610,41,DEEPAK KOSHTI,Independent,250,1,251,0.18
2611,41,PEER MUHMMD (JHAGDU MISTRI),Independent,130,0,130,0.09
2612,41,MOHD. FAROOK,Independent,104,0,104,0.07
2613,41,MAHENDRA KUMAR KORI,Independent,453,2,455,0.32
2614,41,MIRZA RIZBAN BAIG (RANA),Independent,295,0,295,0.21
2615,41,LAXMIKANT RAAZ,Independent,77,0,77,0.05
2616,41,SHAILBALA SUNARYA,Independent,519,4,523,0.37
2617,41,SITADEVI DUBEY,Independent,76,1,77,0.05
2618,41,SHRI SUBODH SHUKLA (ADIPURUSH),Independent,58,1,59,0.04
2619,41,NOTA,None of the Above,629,10,639,0.45
2620,3,ASHOK TIWARI,Communist Party of India (Marxist),1305,15,1320,0.73
2621,3,BAIJ NATH KUSHWAH,Indian National Congress,56286,696,56982,31.63
2622,3,Smt. Sarla vijendra Rawat,Bharatiya Janata Party,66305,482,66787,37.07
2623,3,SONI DHAKAD,Bahujan Samaj Party,50773,380,51153,28.39
2624,3,ABDUL GAFFAR SHAH,Public Political Party,349,0,349,0.19
2625,3,KUN. Er. DHEER SINGH JHUNDPURA,Bharatiya Sampuran Krantikari Party,110,1,111,0.06
2626,3,LAL SINGH RATHOR,Samajwadi Party,1778,3,1781,0.99
2627,3,Shyamveer yadav,Aazad Samaj Party (Kanshi Ram),459,0,459,0.25
2628,3,NARESH SHRiWAS,Independent,168,0,168,0.09
2629,3,RAVENDRA SHRIVASTAVA,Independent,185,1,186,0.1
2630,3,HEMRAJ KEWAT,Independent,267,0,267,0.15
2631,3,NOTA,None of the Above,585,4,589,0.33
2632,74,ENG. DEEPAK SINGH PATEL,Aam Aadmi Party,4990,44,5034,3.32
2633,74,"MADHUMAS CHANDRA SONI ""BUNCHI BHAI""",Bahujan Samaj Party,8482,42,8524,5.61
2634,74,Er. RAJENDRA SHARMA,Indian National Congress,55302,1039,56341,37.11
2635,74,RAJENDRA SHUKLA,Bharatiya Janata Party,76939,741,77680,51.16
2636,74,ABDUL WAFATI ANSARI,Samajwadi Party,615,1,616,0.41
2637,74,"AMIT KUMAR TIWARI, ADVOCATE",Madhya Pradesh Jan Vikas Party,174,2,176,0.12
2638,74,DR. TOSHAN SINGH,Sapaks Party,141,3,144,0.09
2639,74,Adv. RAVI SHANKAR MANJHI,Peoples Party of India (Democratic),225,6,231,0.15
2640,74,RAHAS LAL,National Jagaran Party,145,0,145,0.1
2641,74,RAM KUMAR SONI,Bahujan Mukti Party,153,2,155,0.1
2642,74,AVINASH SHRIVASTAVA,Independent,145,0,145,0.1
2643,74,PRADEEP KUMAR BASOR,Independent,601,1,602,0.4
2644,74,"SUNIL SONI ""KHADDI-42""",Independent,427,0,427,0.28
2645,74,SUMIT SINGH,Independent,474,0,474,0.31
2646,74,SUSHIL MISHRA SABAKE MAHARAJ,Independent,239,1,240,0.16
2647,74,NOTA,None of the Above,886,7,893,0.59
2648,39,GOPAL BHARGAVA,Bharatiya Janata Party,129870,1046,130916,67.04
2649,39,ER. JYOTI PATEL,Indian National Congress,57829,287,58116,29.76
2650,39,ASHOK LODHI,Bhartiya Shakti Chetna Party,1687,1,1688,0.86
2651,39,RAJNI KUSHWAHA,Gondvana Gantantra Party,247,1,248,0.13
2652,39,RAJESH SINGH SOYAM,Gana Suraksha Party,146,0,146,0.07
2653,39,KAMLESH SAHU,Independent,78,0,78,0.04
2654,39,JYOTEE PATEL,Independent,126,0,126,0.06
2655,39,DINESH KURMI,Independent,87,0,87,0.04
2656,39,NANDKISHOR KURMI,Independent,115,4,119,0.06
2657,39,RAJNI GUPTA,Independent,125,1,126,0.06
2658,39,RAJKUMARI KURMI,Independent,146,0,146,0.07
2659,39,SHYAMRANI KURMI,Independent,153,0,153,0.08
2660,39,SAVETRI,Independent,229,0,229,0.12
2661,39,SURYA PATEL,Independent,398,0,398,0.2
2662,39,SOHAN KURMI,Independent,908,1,909,0.47
2663,39,NOTA,None of the Above,1798,3,1801,0.92
2664,210,JITU PATWARI,Indian National Congress,114618,1532,116150,42.44
2665,210,DEVKI MANDLOI,Bahujan Samaj Party,1036,15,1051,0.38
2666,210,MADHU VERMA,Bharatiya Janata Party,150107,1565,151672,55.42
2667,210,AAKASH BODADE,Republican Party of India (A),617,0,617,0.23
2668,210,BHANU PRATAP ATERIA,Peoples Party of India (Democratic),94,1,95,0.03
2669,210,MOHAN SONGARA GOLU,Azad Samaj Party,543,1,544,0.2
2670,210,ASHIF PATEL,Independent,119,2,121,0.04
2671,210,PRADEEP MADHUKAR ( Manjhi),Independent,120,1,121,0.04
2672,210,MADHU VERMA,Independent,564,15,579,0.21
2673,210,RAVI SIRWAIYA,Independent,273,0,273,0.1
2674,210,HEMANT RATHORE,Independent,328,2,330,0.12
2675,210,NOTA,None of the Above,2085,19,2104,0.77
2676,219,MATHURA LAL DAMAR,Bharatiya Janata Party,102717,251,102968,55.83
2677,219,LAXMAN SINGH DINDOR,Indian National Congress,68263,381,68644,37.22
2678,219,SANJAY BHABHAR,Bahujan Samaj Party,1397,3,1400,0.76
2679,219,Dr. ABHAY OHRI,Independent,8517,45,8562,4.64
2680,219,NANALAL KHARADI,Independent,992,1,993,0.54
2681,219,NOTA,None of the Above,1870,4,1874,1.02
2682,220,"CHETANYA KASYAP ""BHAIYYAJI""",Bharatiya Janata Party,108063,1593,109656,67.83
2683,220,ADVOCATE JAHIRUDDIN,Bahujan Samaj Party,624,10,634,0.39
2684,220,PARAS DADA,Indian National Congress,47911,1037,48948,30.28
2685,220,AAFREEN BEE ADVOCATE,Samajwadi Party,349,1,350,0.22
2686,220,MOHAMMAD JAFAR,United National Party,107,0,107,0.07
2687,220,ENGINEER VIJAY SINGH YADAV ( ADVOCATE ),Bhartiya Swarnim Yug Party,101,1,102,0.06
2688,220,ARUN RAO,Independent,307,3,310,0.19
2689,220,Mohansingh Solanki,Independent,183,2,185,0.11
2690,220,NOTA,None of the Above,1341,26,1367,0.85
2691,67,MANIRAJ SINGH,Bahujan Samaj Party,37903,210,38113,19.51
2692,67,RAM SHANKAR PAYASi,Indian National Congress,61798,908,62706,32.1
2693,67,VIKRAM SINGH (VICKY),Bharatiya Janata Party,84785,502,85287,43.66
2694,67,SHASHI DEEPAK SINGH BAGHEL,Aam Aadmi Party,1651,9,1660,0.85
2695,67,Anoop Kumar Prajapati,Bahujan Dravida Party,511,0,511,0.26
2696,67,ASHOK BAUDH,Jan Adhikar Party,180,0,180,0.09
2697,67,PRAMOD KUMAR SHUKLA,Samajwadi Party,197,2,199,0.1
2698,67,RAJ Kumar Singh,Peoples Party of India (Democratic),228,1,229,0.12
2699,67,DR. RAJENDRA TRIPATHI,Bharatiya Jan Morcha Party,195,0,195,0.1
2700,67,LAVKESH SINGH DIKHIT,Bhartiya Shakti Chetna Party,232,2,234,0.12
2701,67,AMBIKA KOL BHARTI,Independent,319,0,319,0.16
2702,67,Amit Kumar Saket,Independent,396,2,398,0.2
2703,67,ONMKARESVAREE TIWARI,Independent,436,0,436,0.22
2704,67,SMT.KAVISHRI SINGH,Independent,959,1,960,0.49
2705,67,"Brijendra, Prasad Pandey ""BHAI SAHAB""",Independent,590,1,591,0.3
2706,67,Mosim khan,Independent,957,0,957,0.49
2707,67,RAMKRISHN KOL,Independent,1107,4,1111,0.57
2708,67,NOTA,None of the Above,1263,2,1265,0.65
2709,188,ANIL - DAYARAM BADOLE,Bahujan Samaj Party,1837,9,1846,0.88
2710,188,ANTAR DEVISINGH PATEL,Bharatiya Janata Party,98881,562,99443,47.33
2711,188,BALA BACHCHAN,Indian National Congress,98960,1373,100333,47.75
2712,188,JANI KARAN,Janhit Kisan Party,1236,0,1236,0.59
2713,188,RAVINDRA VIJAY CHOUHAN,Bharat Adivasi Party,574,2,576,0.27
2714,188,'COMRED' SUKHLAL JHABARSINGH GORE,Communist Party of India,1722,1,1723,0.82
2715,188,ANAND - NANDKISHORE NINGWAL,Independent,849,6,855,0.41
2716,188,NARMDEHAR,Independent,1163,5,1168,0.56
2717,188,SUNIL JAGDISH SOLANKI,Independent,1242,1,1243,0.59
2718,188,NOTA,None of the Above,1672,11,1683,0.8
2719,50,ARVIND PATERIYA,Bharatiya Janata Party,69447,251,69698,38.14
2720,50,Dr. GHASIRAM PATEL,Bahujan Samaj Party,32058,137,32195,17.62
2721,50,RAJU PAL,Aam Aadmi Party,1728,1,1729,0.95
2722,50,VIKRAM SINGH (NAATI RAJA),Indian National Congress,63371,460,63831,34.93
2723,50,BRAJGOPAL PATEL,Samajwadi Party,6349,4,6353,3.48
2724,50,AAPKE IMRAN,Malwa Congress,511,0,511,0.28
2725,50,RAJKUMAR CHAURASIYA,Rashtriya Gondvana Party,248,0,248,0.14
2726,50,RAMKUNWAR/RANI RAIKWAR,Janata Dal (United),470,2,472,0.26
2727,50,AHIRWAR HARIMOHAN ADVOCATE,Jan Adhikar Party,288,3,291,0.16
2728,50,AJAY SINGH YADAV NAAND,Independent,399,1,400,0.22
2729,50,UMAKANT NAMDEV,Independent,295,0,295,0.16
2730,50,DASHRATH KUSHWAHA,Independent,483,0,483,0.26
2731,50,NEERAJ BHAIYA JI,Independent,977,0,977,0.53
2732,50,AHIRWAR POONAM,Independent,752,0,752,0.41
2733,50,PRAMOD KUMAR (BINCHI BABA),Independent,736,0,736,0.4
2734,50,BHOORA PATEL,Independent,1443,0,1443,0.79
2735,50,VIPIN,Independent,954,0,954,0.52
2736,50,VIPIN SHARMA,Independent,399,0,399,0.22
2737,50,BEERENDRA PATEL,Independent,233,0,233,0.13
2738,50,NOTA,None of the Above,762,0,762,0.42
2739,162,AMAR SINGH YADAV,Bharatiya Janata Party,103121,911,104032,53.53
2740,162,ADVOCATE INDER-SINGH-VERMA,Bahujan Samaj Party,1930,14,1944,1
2741,162,BAPU SINGH TANWAR,Indian National Congress,80486,1007,81493,41.93
2742,162,SATISH KUMAR BHARTIYA,Aazad Samaj Party (Kanshi Ram),1941,3,1944,1
2743,162,M. ILYAS,Independent,312,5,317,0.16
2744,162,KAILASH NARAYAN,Independent,689,2,691,0.36
2745,162,TIWARI,Independent,405,3,408,0.21
2746,162,Deepak Mewade,Independent,512,3,515,0.26
2747,162,RATAN SINGH KODKYA,Independent,1254,7,1261,0.65
2748,162,NOTA,None of the Above,1735,7,1742,0.9
2749,62,KALPANA VERMA,Indian National Congress,40841,725,41566,26.46
2750,62,DEVRAJ AHIRWAR,Bahujan Samaj Party,27538,205,27743,17.66
2751,62,Pratima Bagri,Bharatiya Janata Party,76965,661,77626,49.42
2752,62,VARUN GUJAR 'DINKAL',Aam Aadmi Party,1929,9,1938,1.23
2753,62,Indal Prasad,Samajwadi Party,505,5,510,0.32
2754,62,GOPI,Indian Peoples Adhikar Party,143,1,144,0.09
2755,62,BAcHcHA SiSODHiYA,Jan Adhikar Party,186,0,186,0.12
2756,62,Balram Choedhry,Bharatiya Jan Morcha Party,177,0,177,0.11
2757,62,DR. RAJENDRA SINGH,Bahujan Dravida Party,941,5,946,0.6
2758,62,RANI BAGRI,Vindhya Janta Party,2211,29,2240,1.43
2759,62,SMT-SANJU KORI,Peoples Party of India (Democratic),422,3,425,0.27
2760,62,SMT-ARTI VERMA,Independent,482,6,488,0.31
2761,62,KESH KALI DOHAR,Independent,421,0,421,0.27
2762,62,"DHIRENDRA SHINGH ""DHIRU""",Independent,919,1,920,0.59
2763,62,SHiV-NARAYAN-DAHIYA,Independent,755,0,755,0.48
2764,62,NOTA,None of the Above,986,5,991,0.63
